john: john 
coltrane: coltrane 
song: songs 
giant: giant 
step: steps 
death: death 
biography: biography 
skip: skip 
main: main 
content: content 
people: people 
nostalgia: nostalgia 
celebrity: celebrity 
history: history 
culture: culture 
crime: crime 
scandal: scandal 
video: video 
contact: contact 
u: us 
advertise: advertise 
privacy: privacy 
notice: notice 
term: terms 
use: use 
copyright: copyright 
policy: policy 
ad: ad 
choice: choices 
accessibility: accessibility 
support: support 
setting: settings 
february: february 
subscribe: subscribe 
newsletter: newsletter 
photo: photo 
cbs: cbs 
via: via 
getty: getty 
image: images 
quick: quick 
fact: facts fact 
name: name 
birth: birth 
date: date 
september: september 
july: july 
education: education 
ornstein: ornstein 
school: school 
music: music 
place: place 
hamlet: hamlet 
north: north 
carolina: carolina 
huntington: huntington 
long: long 
island: island 
new: new 
york: york 
final: final 
year: years year 
cite: cite 
page: page 
quote: quotes 
play: play 
shoestring: shoestring 
sincere: sincere 
think: think 
expression: expression 
human: human 
heart: heart 
express: express 
happening: happening 
whole: whole 
experience: experience 
particular: particular 
time: time 
expressed: expressed 
situation: situation 
find: find 
life: life lives 
something: something 
feel: feel 
better: better 
must: must 
exert: exert 
effort: effort 
try: try 
make: make 
socially: socially 
musically: musically 
politically: politically 
department: department 
instrument: instruments instrument 
create: create 
initial: initial 
thought: thought 
pattern: patterns 
change: change 
thinking: thinking 
want: want 
force: forces force 
real: real 
good: good 
word: words 
know: know 
bad: bad 
bring: bring 
suffering: suffering 
others: others 
misery: misery 
world: world 
opposite: opposite 
truly: truly 
publish: publish 
apr: apr 
comment: comment 
acclaimed: acclaimed 
american: american 
saxophonist: saxophonist 
bandleader: bandleader bandleaders 
composer: composer 
becoming: becoming 
iconic: iconic 
figure: figure 
jazz: jazz 
th: th 
century: century 
album: albums album 
like: like 
favorite: favorite 
thing: things 
love: love 
supreme: supreme 
xa: xa 
developed: developed 
craft: craft 
working: working 
famed: famed 
musician: musicians musician 
dizzy: dizzy 
gillespie: gillespie 
duke: duke 
ellington: ellington 
mile: miles 
davis: davis 
turned: turned 
head: head 
technically: technically 
marvelous: marvelous 
innovative: innovative 
playing: playing 
thrillingly: thrillingly 
dense: dense 
fluid: fluid 
understanding: understanding 
genre: genre 
virtuosity: virtuosity 
vision: vision 
could: could 
heard: heard 
revered: revered 
among: among 
died: died 
liver: liver 
cancer: cancer 
old: old 
background: background 
early: early 
revolutionary: revolutionary 
groundbreaking: groundbreaking 
william: william 
born: born 
growing: growing 
nearby: nearby 
high: high 
point: point 
surrounded: surrounded 
child: children child 
father: father 
r: r 
worked: worked 
tailor: tailor 
passion: passion 
several: several 
younger: younger 
influence: influences 
included: included 
legend: legends 
count: count 
basie: basie 
lester: lester 
young: young 
teen: teens 
picked: picked 
alto: alto 
saxophone: saxophone 
displayed: displayed 
immediate: immediate 
talent: talent 
family: family 
took: took 
tragic: tragic 
turn: turn 
passing: passing 
along: along 
relative: relatives 
financial: financial 
struggle: struggles 
defined: defined 
period: period 
eventually: eventually 
mother: mother 
alice: alice 
member: members 
moved: moved 
jersey: jersey 
hope: hopes 
improved: improved 
remained: remained 
graduated: graduated 
specifically: specifically 
philadelphia: philadelphia 
go: go 
short: short 
studied: studied 
country: country 
throe: throes 
war: war 
called: called 
duty: duty 
enlisted: enlisted 
navy: navy 
service: service 
stationed: stationed 
hawaii: hawaii 
regularly: regularly 
performed: performed 
made: made 
first: first 
recording: recordings recording 
quartet: quartet 
fellow: fellow 
sailor: sailors 
joining: joining 
upon: upon 
return: return 
civilian: civilian 
summer: summer 
landed: landed 
back: back 
granoff: granoff 
proceeded: proceeded 
hook: hook 
number: number 
band: band bands 
one: one 
earliest: earliest 
group: group 
led: led 
eddie: eddie 
cleanhead: cleanhead 
vinson: vinson 
switched: switched 
tenor: tenor 
sax: sax 
later: later 
joined: joined 
jimmy: jimmy 
heath: heath 
began: began 
fully: fully 
explore: explore 
experimental: experimental 
side: side 
fall: fall 
signed: signed 
big: big 
trumpeter: trumpeter 
remaining: remaining 
next: next 
half: half 
started: started 
earn: earn 
case: case 
performer: performers 
drug: drug drugs 
mainly: mainly 
heroin: heroin 
earned: earned 
gig: gigs 
addiction: addictions addiction 
ended: ended 
prematurely: prematurely 
brought: brought 
temporarily: temporarily 
replace: replace 
johnny: johnny 
hodges: hodges 
soon: soon 
fired: fired 
dependency: dependency 
rebounded: rebounded 
mid: mid 
asked: asked 
join: join 
quintet: quintet 
encouraged: encouraged 
push: push 
creative: creative 
boundary: boundaries 
holding: holding 
accountable: accountable 
habit: habits habit 
record: record records 
contract: contract 
columbia: columbia 
proved: proved 
fruitful: fruitful 
artistically: artistically 
rewarding: rewarding 
round: round 
midnight: midnight 
also: also 
played: played 
seminal: seminal 
masterpiece: masterpiece 
kind: kind 
blue: blue 
train: train 
previously: previously 
rehired: rehired 
bandmate: bandmate 
failed: failed 
give: give 
whether: whether 
exact: exact 
impetus: impetus 
finally: finally 
getting: getting 
sober: sober 
certain: certain 
kicked: kicked 
pianist: pianist 
thelonious: thelonious 
monk: monk 
month: months 
developing: developing 
solo: solo 
artist: artists artist 
heralded: heralded 
release: release 
soultrane: soultrane 
start: start 
decade: decades decade 
debut: debut 
atlantic: atlantic 
penning: penning 
material: material 
nurtured: nurtured 
distinctive: distinctive 
sound: sound sounds 
part: part 
ability: ability 
note: notes 
amid: amid 
wondrous: wondrous 
cascade: cascades 
scale: scales 
dubbed: dubbed 
critic: critic 
ira: ira 
gitler: gitler 
sheet: sheets 
technique: techniques technique 
reportedly: reportedly 
described: described 
way: way 
middle: middle 
sentence: sentence 
move: move 
direction: directions 
x: x 
read: read 
bella: bella 
hadid: hadid 
sadie: sadie 
alexander: alexander 
adrienne: adrienne 
kennedy: kennedy 
autumn: autumn 
mccoy: mccoy 
tyner: tyner 
bassist: bassist 
steve: steve 
drummer: drummer 
elvin: elvin 
jones: jones 
title: title 
track: tracks track 
additional: additional 
standard: standards 
ev: ev 
ry: ry 
say: say 
goodbye: goodbye 
summertime: summertime 
enduring: enduring 
performance: performance 
soprano: soprano 
catapulted: catapulted 
stardom: stardom 
lauded: lauded 
smaller: smaller 
degree: degree 
criticized: criticized 
impression: impressions 
live: live 
birdland: birdland 
arguably: arguably 
globally: globally 
succinct: succinct 
four: four 
suite: suite 
seller: seller 
went: went 
gold: gold 
noted: noted 
astounding: astounding 
technical: technical 
nuanced: nuanced 
spiritual: spiritual 
exploration: explorations 
ultimate: ultimate 
transcendence: transcendence 
work: work 
nominated: nominated 
two: two 
grammys: grammys 
considered: considered 
hallmark: hallmark 
historian: historians 
around: around 
wife: wives wife 
married: married 
juanita: juanita 
naima: naima 
grubbs: grubbs 
wed: wed 
harpist: harpist 
mcleod: mcleod 
macleod: macleod 
according: according 
source: sources 
would: would 
husband: husband 
establish: establish 
unique: unique 
career: career 
asian: asian 
stylistic: stylistic 
fusion: fusions 
divine: divine 
orientation: orientation 
wrote: wrote 
recorded: recorded 
considerable: considerable 
amount: amount 
avant: avant 
garde: garde 
steeped: steeped 
poignant: poignant 
spirituality: spirituality 
spurned: spurned 
last: last 
released: released 
alive: alive 
kulu: kulu 
se: se 
mama: mama 
meditation: meditations 
finalized: finalized 
day: days day 
survived: survived 
second: second 
lost: lost 
june: june 
impulse: impulse 
announced: announced 
plan: plans 
b: b 
oth: oth 
collection: collection 
recently: recently 
found: found 
single: single 
march: march 
classic: classic 
garrison: garrison 
studio: studio 
version: version 
concert: concert 
well: well 
original: original 
untitled: untitled 
believed: believed 
solely: solely 
legacy: legacy 
voracious: voracious 
reader: reader 
gentleness: gentleness 
immense: immense 
impact: impact 
revolutionized: revolutionized 
demanding: demanding 
showing: showing 
deep: deep 
reverence: reverence 
locale: locales 
africa: africa 
latin: latin 
america: america 
far: far 
east: east 
south: south 
asia: asia 
received: received 
grammy: grammy 
posthumously: posthumously 
bye: bye 
blackbird: blackbird 
given: given 
lifetime: lifetime 
achievement: achievement 
award: award 
array: array 
unearthed: unearthed 
reissue: reissues 
since: since 
pulitzer: pulitzer 
prize: prize 
board: board 
awarded: awarded 
special: special 
posthumous: posthumous 
citation: citation 
continues: continues 
integral: integral 
sonic: sonic 
landscape: landscape 
major: major 
inspiration: inspiration 
newer: newer 
generation: generations 
check: check 
strive: strive 
accuracy: accuracy 
fairness: fairness 
see: see 
look: look 
right: right rights 
information: information 
article: article 
author: author 
com: com 
editor: editors 
website: website 
url: url 
access: access 
publisher: publisher 
e: e 
television: television 
network: networks 
updated: updated 
april: april 
published: published 
receive: receive 
story: stories 
shaped: shaped 
sign: sign 
person: person 
billie: billie 
holiday: holiday 
influential: influential 
singer: singers singer 
thriving: thriving 
many: many 
battle: battle 
winner: winner 
trumpet: trumpet 
player: player 
charlie: charlie 
parker: parker 
legendary: legendary 
winning: winning 
invented: invented 
musical: musical 
style: style 
bop: bop 
bebop: bebop 
greatest: greatest 
creator: creators 
modern: modern 
ray: ray 
charles: charles 
pioneer: pioneer 
soul: soul 
integrating: integrating 
gospel: gospel 
pop: pop 
hit: hits hit 
unchain: unchain 
road: road 
jack: jack 
georgia: georgia 
mind: mind 
louis: louis 
armstrong: armstrong 
known: known 
wonderful: wonderful 
hello: hello 
dolly: dolly 
star: star 
dust: dust 
la: la 
vie: vie 
en: en 
rose: rose 
originator: originator 
composed: composed 
thousand: thousands 
score: scores 
lewis: lewis 
six: six 
leader: leaders 
civil: civil 
movement: movement 
continued: continued 
fight: fight 
congress: congress 
best: best 
composition: compositions 
include: include 
oop: oop 
bob: bob 
sh: sh 
bam: bam 
salt: salt 
peanut: peanuts 
night: night 
tunisia: tunisia 
loading: loading 
logo: logo 
registered: registered 
trademark: trademarks 
llc: llc 
close: close 
