body: body 
margin: margin 
top: top 
important: important 
padding: padding 
min: min 
width: width 
px: px 
wm: wm 
rw: rw 
iframe: iframe 
id: id 
donato: donato 
src: src 
platform: platform 
wb: wb 
referer: referer 
web: web 
archive: archive 
org: org 
www: www 
secnetix: secnetix 
de: de 
olli: olli 
python: python 
block: blocks block 
indentation: indentation indentations 
hawk: hawk 
scrolling: scrolling 
frameborder: frameborder 
style: style 
height: height 
capture: capture captures 
mar: mar 
feb: feb 
dec: dec 
sep: sep 
success: success 
fail: fail 
save: save 
snapshot: snapshot 
open: open 
href: href 
title: title 
share: share 
via: via 
screenshot: screenshot 
collected: collected 
organization: organization 
team: team 
formed: formed 
confused: confused 
rogue: rogue 
archivist: archivist 
collective: collective 
dedicated: dedicated 
saving: saving 
copy: copy copies 
rapidly: rapidly 
dying: dying 
deleted: deleted 
website: websites 
sake: sake 
history: history 
digital: digital 
heritage: heritage 
group: group 
composed: composed 
volunteer: volunteer volunteers 
interested: interested 
party: parties 
expanded: expanded 
large: large 
amount: amount 
related: related 
project: projects 
online: online 
littered: littered 
hundred: hundreds hundred 
conflict: conflicts 
future: future 
community: community 
location: location 
business: business 
resolved: resolved 
one: one 
stepped: stepped 
ahead: ahead 
destroyed: destroyed 
original: original 
point: point 
contention: contention 
debate: debate debates 
would: would 
fall: fall 
wayside: wayside 
belief: believes 
duplicated: duplicated 
condemned: condemned 
data: data 
conversation: conversation 
continue: continue 
well: well 
richness: richness 
insight: insight 
gained: gained 
keeping: keeping 
material: materials 
ranged: ranged 
size: size 
single: single 
downloading: downloading 
small: small 
critical: critical 
site: sites site 
stepping: stepping 
forward: forward 
acquire: acquire 
terabyte: terabyte terabytes 
user: user 
created: created 
generation: generations 
main: main 
archiveteam: archiveteam 
contains: contains 
date: date 
information: information 
various: various 
manifesto: manifestos 
plan: plans 
walkthroughs: walkthroughs 
collection: collection collections 
output: output 
many: many 
ongoing: ongoing 
completed: completed 
thanks: thanks 
generous: generous 
providing: providing 
disk: disk 
space: space spaces 
internet: internet 
multi: multi 
datasets: datasets 
made: made 
available: available 
use: use 
wayback: wayback 
machine: machine machines 
path: path 
back: back 
lost: lost 
work: work 
grown: grown 
sub: sub 
type: types type 
seeking: seeking 
browse: browse 
content: content contents 
best: best 
first: first 
stop: stops stop 
otherwise: otherwise 
free: free 
dig: dig 
stack: stacks stack 
see: see 
may: may 
find: find 
panic: panic 
downloads: downloads 
full: full 
pulldowns: pulldowns 
currently: currently 
extant: extant 
meant: meant 
serve: serve 
emergency: emergency 
backup: backups 
needed: needed 
danger: danger 
closing: closing 
missed: missed 
dearly: dearly 
suddenly: suddenly 
due: due 
hard: hard 
drive: drive 
crash: crashes 
server: servers server 
failure: failures 
archivebot: archivebot 
crowdsourced: crowdsourced 
crawler: crawler 
irc: irc 
bot: bot 
designed: designed 
automate: automate 
archival: archival 
smaller: smaller 
e: e 
g: g 
thousand: thousand 
url: urls url 
give: give 
start: starts start 
grab: grabs 
record: records 
warc: warc 
uploads: uploads 
eventual: eventual 
injection: injection 
drop: drop 
efnet: efnet 
interact: interact 
issue: issue 
command: commands 
typing: typing 
channel: channel 
note: note 
need: need 
operator: operator 
permission: permissions 
order: order 
archiving: archiving 
job: jobs 
dashboard: dashboard 
show: shows 
downloaded: downloaded 
running: running 
process: process 
source: source 
code: code 
found: found 
timestamps: timestamps 
bt: bt 
false: false 
myth: myths 
line: lines line 
beginning: beginning 
indicate: indicate 
input: input 
default: default 
prompt: prompts 
interactive: interactive 
interpreter: interpreter 
everything: everything 
else: else 
quite: quite 
prejudice: prejudices 
rule: rules 
among: among 
people: people 
really: really 
know: know 
try: try 
address: address 
concern: concerns 
page: page 
whitespace: whitespace 
significant: significant 
general: general 
level: levels level 
statement: statement statements 
left: left 
everywhere: everywhere 
used: used 
like: like 
language: language 
also: also 
insert: insert 
empty: empty 
contain: contain 
nothing: nothing 
arbitrary: arbitrary 
anywhere: anywhere 
exact: exact 
matter: matter 
relative: relative 
nested: nested 
furthermore: furthermore 
ignored: ignored 
explicit: explicit 
implicit: implicit 
continuation: continuation 
example: example 
split: split 
list: list 
across: across 
multiple: multiple 
completely: completely 
insignificant: insignificant 
want: want 
thing: things thing 
foo: foo 
string: string 
another: another 
short: short 
print: print 
bar: bar 
long: long 
force: forces 
certain: certain 
yes: yes 
write: write 
inner: inner 
therefore: therefore 
care: care 
intendation: intendation 
following: following 
three: three 
version: versions version 
valid: valid 
exactly: exactly 
omitted: omitted 
brevity: brevity 
x: x 
course: course 
time: time 
separate: separate 
sometimes: sometimes 
bunch: bunch 
similar: similar 
conveniently: conveniently 
written: written 
decide: decide 
obey: obey 
simply: simply 
mean: means 
enclosed: enclosed 
two: two 
assignment: assignment 
indented: indented 
frankly: frankly 
indent: indent 
way: way 
think: think 
conclusion: conclusion 
anyway: anyway 
unless: unless 
wanted: wanted 
obfuscate: obfuscate 
structure: structure 
program: program programs 
word: words 
allow: allow 
using: using 
bogus: bogus 
opinion: opinion 
good: good 
ever: ever 
seen: seen 
c: c 
warning: warning 
condition: condition 
something: something 
fancy: fancy 
suck: sucks 
badluck: badluck 
either: either 
wrong: wrong 
buggy: buggy 
always: always 
applies: applies 
nearest: nearest 
brace: braces 
essential: essential 
problem: problems problem 
could: could 
resort: resort 
tiresome: tiresome 
bloat: bloats 
prevent: prevent 
accidentally: accidentally 
obfuscating: obfuscating 
still: still 
simple: simple 
practice: practice 
much: much 
complex: complex 
never: never 
occur: occur 
logical: logical 
consistent: consistent 
expect: expect 
look: look looks 
quoting: quoting 
famous: famous 
book: book 
writer: writer 
bruce: bruce 
eckel: eckel 
denoted: denoted 
uniform: uniform 
meaningful: meaningful 
u: us u 
reader: readers 
formatting: formatting 
read: read 
somebody: somebody 
constantly: constantly 
tripping: tripping 
oh: oh 
putting: putting 
curly: curly 
cannot: cannot 
safely: safely 
mix: mix 
tab: tabs tab 
right: right 
make: make 
difference: difference 
compiler: compiler 
big: big 
human: humans 
looking: looking 
move: move 
piece: piece 
editor: editors editor 
different: different 
tabstops: tabstops 
possibly: possibly 
behave: behave 
differently: differently 
sight: sight 
easily: easily 
introduce: introduce 
hidden: hidden 
bug: bugs 
mangled: mangled 
mixing: mixing 
safe: safe 
generally: generally 
idea: idea 
fine: fine 
avoid: avoid 
alltogether: alltogether 
semantics: semantics 
defined: defined 
computer: computer 
world: world 
displayed: displayed 
system: systems 
often: often 
get: get 
wrongly: wrongly 
converted: converted 
paste: paste 
operation: operations 
inserted: inserted 
kind: kind 
markup: markup 
support: support 
transparent: transparent 
translation: translation 
automatic: automatic 
dedent: dedent 
press: press 
key: key 
enough: enough 
actual: actual 
character: characters 
next: next 
position: position positions 
eight: eight 
four: four 
whatever: whatever 
prefer: prefer 
usually: usually 
backspace: backspace 
previous: previous 
behaving: behaving 
maintaining: maintaining 
portability: portability 
file: file 
convenient: convenient 
said: said 
liking: liking 
tool: tool tools 
expand: expand 
unix: unix 
giving: giving 
others: others 
assumes: assumes 
apart: apart 
perfectly: perfectly 
ok: ok 
dislike: dislike 
probably: probably 
alone: alone 
granted: granted 
fact: fact 
might: might 
regarded: regarded 
uncommon: uncommon 
requiring: requiring 
lot: lot 
advantage: advantages 
quickly: quickly 
seriously: seriously 
programming: programming 
keywords: keywords 
end: end 
instead: instead 
endif: endif 
come: comes 
convert: converts 
correct: correct 
remove: removes 
pre: pre 
processor: processor 
however: however 
real: real 
programmer: programmer 
us: uses 
update: update 
seems: seems 
removed: removed 
recent: recent 
nobody: nobody 
parse: parse 
parsing: parsing 
basically: basically 
change: changes 
token: tokens token 
stream: stream 
lexical: lexical 
analyzer: analyzer 
tokenizer: tokenizer 
store: store 
value: values value 
leftmost: leftmost 
whenever: whenever 
begin: begins 
new: new 
pushed: pushed 
passed: passed 
parser: parser 
row: row 
encountered: encountered 
popped: popped 
equal: equal 
none: none 
syntax: syntax 
error: error 
occurs: occurs 
generated: generated 
obviously: obviously 
sample: sample 
table: table 
produced: produced 
analysis: analysis 
except: except 
within: within 
literal: literals 
handled: handled 
lexer: lexer 
handle: handles 
delimiters: delimiters 
intentionally: intentionally 
reference: reference 
includes: includes 
complete: complete 
formal: formal 
grammar: grammar 
archived: archived 
retrieved: retrieved 
javascript: javascript 
appended: appended 
copyright: copyright 
protected: protected 
section: section 
playback: playback 
timing: timings 
m: ms 
exclusion: exclusion 
robot: robots 
policy: policy 
rediscdxsource: rediscdxsource 
esindex: esindex 
loadshardblock: loadshardblock 
petaboxloader: petaboxloader 
datanode: datanode 
cdxlines: cdxlines 
iter: iter 
resolve: resolve 
load: load 
resource: resource 
