mercurial: mercurial 
wikipedia: wikipedia 
free: free 
encyclopedia: encyclopedia 
jump: jump 
navigation: navigation 
search: search 
distributed: distributed 
revision: revision revisions 
control: control 
tool: tool tools 
software: software 
developer: developers developer 
mw: mw 
parser: parser 
output: output 
hatnote: hatnote 
font: font 
style: styles style 
italic: italics italic 
div: div 
padding: padding 
left: left 
em: em 
margin: margin 
bottom: bottom 
normal: normal 
link: link links 
top: top 
shadowrun: shadowrun 
adventure: adventure 
see: see 
infobox: infobox 
subbox: subbox 
border: border 
none: none 
px: px 
width: width 
auto: auto 
min: min 
size: size 
clear: clear 
float: float 
background: background 
color: color 
transparent: transparent 
col: col cols 
child: child 
navbar: navbar 
body: body 
skin: skin 
minerva: minerva 
header: header 
subheader: subheader 
title: title 
image: image 
full: full 
data: data 
text: text 
align: align 
center: center 
olivia: olivia 
mackall: mackall 
initial: initial 
release: release 
april: april 
year: years 
ago: ago 
stable: stable 
february: february 
repository: repository repositories 
www: www 
scm: scm 
org: org 
repo: repo 
hg: hg 
written: written 
python: python 
c: cs c 
rust: rust 
operating: operating 
system: system systems 
unix: unix 
like: like 
window: windows 
macos: macos 
type: type 
version: version 
license: license 
gpl: gpl 
later: later 
website: website websites 
supported: supported 
microsoft: microsoft 
freebsd: freebsd 
linux: linux 
major: major 
design: design 
goal: goals 
include: include 
high: high 
performance: performance 
scalability: scalability 
decentralization: decentralization 
fully: fully 
collaborative: collaborative 
development: development 
robust: robust 
handling: handling 
plain: plain 
binary: binary 
file: files file 
advanced: advanced 
branching: branching 
merging: merging 
capability: capabilities 
remaining: remaining 
conceptually: conceptually 
simple: simple 
includes: includes 
integrated: integrated 
web: web 
interface: interface 
also: also 
taken: taken 
step: steps 
ease: ease 
transition: transition 
user: users user 
particularly: particularly 
subversion: subversion 
primarily: primarily 
command: command 
line: lines line 
driven: driven 
program: program 
graphical: graphical 
extension: extensions 
available: available 
e: e 
g: g 
tortoisehg: tortoisehg 
several: several 
ides: ides 
offer: offer 
support: support 
operation: operations 
invoked: invoked 
argument: arguments argument 
driver: driver 
reference: reference references 
chemical: chemical 
symbol: symbol 
element: element 
mercury: mercury 
originated: originated 
served: served 
lead: lead 
late: late 
released: released 
mainly: mainly 
implemented: implemented 
using: using 
programming: programming 
language: language 
diff: diff 
implementation: implementations implementation 
content: content contents 
history: history 
usage: usage 
adoption: adoption 
server: server servers 
management: management 
source: source sources 
code: code 
hosting: hosting 
open: open 
project: project projects 
note: notes 
external: external 
edit: edit 
first: first 
announced: announced 
impetus: impetus 
announcement: announcement 
earlier: earlier 
month: month 
bitmover: bitmover 
withdrawing: withdrawing 
bitkeeper: bitkeeper 
sourcepuller: sourcepuller 
used: used 
requirement: requirements 
kernel: kernel 
decided: decided 
write: write 
replacement: replacement 
use: use 
started: started 
day: days 
well: well 
known: known 
git: git 
initiated: initiated 
linus: linus 
torvalds: torvalds 
similar: similar 
aim: aims 
rather: rather 
many: many 
answer: answer 
mailing: mailing 
list: list 
explained: explained 
name: names name 
chosen: chosen 
templatequote: templatequote 
overflow: overflow 
hidden: hidden 
templatequotecite: templatequotecite 
height: height 
shortly: shortly 
read: read 
article: articles article 
ongoing: ongoing 
debacle: debacle 
described: described 
larry: larry 
mcvoy: mcvoy 
sense: sense 
fickle: fickle 
given: given 
multiple: multiple 
meaning: meanings 
convenient: convenient 
abbreviation: abbreviation 
good: good 
fit: fit 
pre: pre 
existing: existing 
naming: naming 
scheme: scheme 
email: email 
address: address 
clicked: clicked 
instantly: instantly 
thus: thus 
named: named 
honor: honor 
know: know 
true: true 
profile: profile 
java: java 
openjdk: openjdk 
longer: longer 
us: uses 
sha: sha 
hash: hashes 
identify: identify 
access: access 
via: via 
network: network 
based: based 
protocol: protocol 
seek: seeks 
reduce: reduce 
round: round 
trip: trip 
request: requests 
new: new 
connection: connections 
transferred: transferred 
work: work 
ssh: ssh 
default: default 
way: way 
merge: merge 
calling: calling 
figure: figure 
show: shows 
important: important 
relation: relations 
concept: concepts 
although: although 
selected: selected 
manage: manage 
adopted: adopted 
organization: organizations 
including: including 
facebook: facebook 
w: w ws 
mozilla: mozilla 
mononoke: mononoke 
specifically: specifically 
designed: designed 
large: large 
multi: multi 
began: began 
scaling: scaling 
handle: handle 
unified: unified 
google: google 
piper: piper 
monorepo: monorepo 
bitbucket: bitbucket 
service: services 
would: would 
end: end 
june: june 
extended: extended 
july: july 
explaining: explaining 
le: less 
survey: surveys 
indicated: indicated 
meanwhile: meanwhile 
hundred: hundreds 
openly: openly 
questioned: questioned 
reasoning: reasoning 
massively: massively 
deleting: deleting 
historical: historical 
asked: asked 
significant: significant 
warning: warning 
formal: formal 
migration: migration 
plan: plan 
panicked: panicked 
rushed: rushed 
timing: timing 
official: official 
company: company 
thread: thread 
heptapod: heptapod 
gitlab: gitlab 
fork: fork 
octobus: octobus 
kallithea: kallithea 
gplv: gplv 
rhodecode: rhodecode 
kiln: kiln 
fog: fog 
creek: creek 
phabricator: phabricator 
phacility: phacility 
inc: inc 
comparison: comparison 
facility: facilities 
following: following 
provide: provide 
atlassian: atlassian 
deprecated: deprecated 
since: since 
codebase: codebase 
fusionforge: fusionforge 
gnu: gnu 
savannah: savannah 
fsf: fsf 
mozdev: mozdev 
osdn: osdn 
others: others 
perforce: perforce 
puszcza: puszcza 
sister: sister 
site: site 
hosted: hosted 
ukraine: ukraine 
sourceforge: sourceforge 
sourcehut: sourcehut 
tuxfamily: tuxfamily 
rcs: rcs 
column: columns column 
small: small 
rule: rule rules 
solid: solid 
aaa: aaa 
dl: dl 
ol: ol 
ul: ul 
li: li 
dd: dd 
page: page 
break: break 
inside: inside 
avoid: avoid 
health: health 
precision: precision 
library: library 
octave: octave 
lemon: lemon 
liquidfeedback: liquidfeedback 
github: github 
nginx: nginx 
orthanc: orthanc 
pidgin: pidgin 
roundup: roundup 
tryton: tryton 
windirstat: windirstat 
wmii: wmii 
xemacs: xemacs 
xine: xine 
portalbox: portalbox 
right: right 
tleft: tleft 
tright: tright 
display: display 
table: table 
box: box 
sizing: sizing 
max: max 
f: f 
weight: weight 
bold: bold 
row: row 
span: span 
cell: cell 
vertical: vertical 
middle: middle 
last: last 
portal: portal 
reflist: reflist 
decimal: decimal 
inherit: inherit 
upper: upper 
alpha: alpha 
roman: roman 
lower: lower 
greek: greek 
b: b 
formerly: formerly 
matt: matt 
cite: cite 
citation: citation 
word: word 
wrap: wrap 
q: q 
quote: quotes 
target: target 
rgba: rgba 
id: id 
lock: lock 
linear: linear 
gradient: gradient 
url: url 
upload: upload 
wikimedia: wikimedia 
common: commons 
green: green 
svg: svg 
repeat: repeat 
limited: limited 
registration: registration 
gray: gray 
alt: alt 
subscription: subscription 
aa: aa 
red: red 
icon: icon 
wikisource: wikisource 
logo: logo 
error: error 
visible: visible 
maint: maint 
format: format 
kern: kern 
selflink: selflink 
v: vs v 
minimal: minimal 
scalable: scalable 
readme: readme 
subdirectory: subdirectory 
master: master 
branch: branch 
january: january 
retrieved: retrieved 
towards: towards 
better: better 
revlog: revlog 
pdf: pdf 
archived: archived 
original: original 
may: may 
status: status 
relicensing: relicensing 
wiki: wiki 
patchbomb: patchbomb 
benchmark: benchmark 
choose: choose 
said: said 
egotistical: egotistical 
bastard: bastard 
james: james 
gosling: gosling 
october: october 
sourcing: sourcing 
sun: sun 
platform: platform 
part: part 
interview: interview 
interviewed: interviewed 
robert: robert 
eckstein: eckstein 
march: march 
unfit: unfit 
monorepos: monorepos 
facebookexperimental: facebookexperimental 
szorc: szorc 
gregory: gregory 
sprint: sprint 
dev: dev 
group: groups group 
goode: goode 
durham: durham 
agarwal: agarwal 
siddharth: siddharth 
store: stores 
billion: billions 
single: single 
sunsetting: sunsetting 
chan: chan 
denise: denise 
august: august 
repos: repos 
sunset: sunsets 
feature: features 
hq: hq 
let: let 
start: start 
os: oss 
net: net 
try: try 
helix: helix 
teamhub: teamhub 
info: info 
com: com 
welcome: welcome 
p: ps 
ua: ua 
people: people 
reed: reed 
j: j 
paul: paul 
shootout: shootout 
redux: redux 
mobile: mobile 
fenix: fenix 
look: look 
wiktionary: wiktionary 
dictionary: dictionary 
medium: media 
related: related 
floss: floss 
podcast: podcast 
week: week 
tech: tech 
sullivan: sullivan 
bryan: bryan 
definitive: definitive 
guide: guide 
book: book 
reilly: reilly 
freely: freely 
online: online 
spolsky: spolsky 
joel: joel 
tutorial: tutorial 
example: example 
se: se 
jemander: jemander 
covering: covering 
basic: basic 
alternative: alternative 
lwn: lwn 
cv: cvs 
bazaar: bazaar 
four: four 
compared: compared 
javaworld: javaworld 
september: september 
techtalk: techtalk 
video: video 
december: december 
navbox: navbox 
inner: inner 
subgroup: subgroup 
abovebelow: abovebelow 
white: white 
space: space 
nowrap: nowrap 
fdfdfd: fdfdfd 
tr: tr 
ccf: ccf 
ddf: ddf 
ff: ff 
even: even 
odd: odd 
hlist: hlist 
td: td 
block: block 
inline: inline 
collapse: collapse 
boxtext: boxtext 
spacing: spacing 
bracket: brackets 
abbr: abbr 
decoration: decoration 
mini: mini 
variant: variant 
cap: caps 
cursor: cursor 
ct: ct 
indicate: indicate 
date: dates date 
maintained: maintained 
planned: planned 
life: life 
local: local 
sccs: sccs 
proprietary: proprietary 
pvc: pvcs 
qvcs: qvcs 
client: client 
cvsnt: cvsnt 
enterprise: enterprise 
accurev: accurev 
azure: azure 
devops: devops 
tfvc: tfvc 
clearcase: clearcase 
cmvc: cmvc 
dimension: dimensions 
cm: cm 
dsee: dsee 
endevor: endevor 
integrity: integrity 
panvalet: panvalet 
sclm: sclm 
change: change 
manager: manager 
starteam: starteam 
surround: surround 
synergy: synergy 
team: team 
concert: concert 
vault: vault 
visual: visual 
sourcesafe: sourcesafe 
arx: arx 
breezy: breezy 
darcs: darcs 
dcvs: dcvs 
fossil: fossil 
arch: arch 
monotone: monotone 
teamware: teamware 
co: co 
op: op 
plastic: plastic 
baseline: baseline 
changeset: changeset 
commit: commit 
delta: deltas delta 
compression: compression 
gated: gated 
interleaved: interleaved 
tag: tag 
trunk: trunk 
category: categories category 
newpp: newpp 
limit: limit 
report: report 
parsed: parsed 
cached: cached 
time: time 
cache: cache 
expiry: expiry 
reduced: reduced 
false: false 
complication: complications 
vary: vary 
cpu: cpu 
second: seconds 
real: real 
preprocessor: preprocessor 
visited: visited 
node: node 
count: count 
post: post 
expand: expand 
byte: bytes 
template: template 
highest: highest 
expansion: expansion 
depth: depth 
expensive: expensive 
function: function 
unstrip: unstrip 
recursion: recursion 
lua: lua 
memory: memory 
number: number 
wikibase: wikibase 
entity: entities 
loaded: loaded 
transclusion: transclusion 
m: ms 
call: calls 
total: total 
short: short 
description: description 
saved: saved 
key: key 
enwiki: enwiki 
pcache: pcache 
idhash: idhash 
canonical: canonical 
timestamp: timestamp 
serialized: serialized 
json: json 
oldid: oldid 
cross: cross 
programmed: programmed 
different: different 
wikidata: wikidata 
dmy: dmy 
menu: menu 
