function: function 
var: var 
node: node 
document: document 
getelementbyid: getelementbyid 
mw: mw 
dismissablenotice: dismissablenotice 
anonplace: anonplace 
outerhtml: outerhtml 
u: u 
cdiv: cdiv 
class: classes class 
dismissable: dismissable 
notice: notice 
e: e 
close: close 
ca: ca 
tabindex: tabindex 
role: role 
button: button 
c: cs c 
div: div 
body: body 
id: id 
localnotice: localnotice 
anonnotice: anonnotice 
lang: lang 
el: el 
dir: dir 
ltr: ltr 
plainlinks: plainlinks 
style: style 
border: border 
px: px 
solid: solid 
ddd: ddd 
radius: radius 
margin: margin 
background: background 
color: color 
fefefe: fefefe 
image: image 
linear: linear 
gradient: gradient 
f: f 
n: n 
darkslategray: darkslategray 
max: max 
width: width 
auto: auto 
text: text 
align: align 
center: center 
font: font 
size: size 
rem: rem 
position: position 
relative: relative 
cb: cb 
b: b 
cbr: cbr 
cspan: cspan 
em: em 
span: span 
python: python 
interpreted: interpreted 
general: general 
purpose: purpose 
imperative: imperative 
programming: programming 
procedural: procedural 
object: object 
oriented: oriented 
paradigm: paradigm 
dynamically: dynamically 
typed: typed 
garbage: garbage 
collection: collection 
gc: gc 
guido: guido 
van: van 
rossum: rossum 
centrum: centrum 
wiskunde: wiskunde 
informatica: informatica 
cwi: cwi 
java: java 
compiled: compiled 
py: py 
exe: exe 
pyinstaller: pyinstaller 
open: open 
source: source 
software: software 
foundation: foundation 
license: license licenses 
gpl: gpl 
idle: idle 
primitive: primitive 
list: list 
tuple: tuple 
dictionary: dictionary 
assignment: assignment 
indentation: indentation 
scope: scope 
global: global 
amoeba: amoeba 
abc: abc 
k: k 
interactively: interactively 
download: download 
www: www 
org: org 
microsoft: microsoft 
window: windows 
bit: bits 
linux: linux 
mac: mac 
o: os 
x: x 
integrated: integrated 
development: development 
environment: environment 
ide: ide 
dle: dle 
interactive: interactive 
tkinter: tkinter 
debugging: debugging 
compiler: compiler 
tcl: tcl 
perl: perl 
scheme: scheme 
ruby: ruby 
underscore: underscore 
case: case 
sensitivity: sensitivity 
keywords: keywords 
idetifiers: idetifiers 
print: print 
type: type 
false: false 
float: float 
none: none 
data: data 
interpreter: interpreter 
nameerror: nameerror 
nonetype: nonetype 
int: int 
str: str 
string: string strings 
bool: bool 
boolean: boolean 
true: true 
return: return 
character: character 
set: set 
array: array 
item: items 
element: elements 
operator: operators 
method: methods 
mutable: mutable 
immutable: immutable 
overwriting: overwriting 
expression: expressions expression 
key: key 
value: value 
interer: interer 
floating: floating 
point: point 
integer: integer 
memory: memory 
allocation: allocation 
address: address 
pointer: pointer 
hellow: hellow 
world: world 
collector: collector 
de: de 
block: blocks block 
nested: nested 
spacebars: spacebars 
operand: operands 
concatenation: concatenation 
replication: replication 
def: def 
abcdef: abcdef 
abcabcabc: abcabcabc 
name: name 
binding: binding 
local: local 
num: num 
hello: hello 
whitespace: whitespace 
code: code 
age: age 
vote: vote 
else: else 
generator: generator 
generate: generate 
prime: primes 
itertools: itertools 
import: import 
count: count 
stop: stop 
composite: composite 
p: p 
break: break 
elif: elif 
append: append 
yield: yield 
employee: employee 
init: init 
self: self 
printemployee: printemployee 
first: first 
avouris: avouris 
et: et 
al: al 
medium: media 
study: studies 
guzdial: guzdial 
mathesis: mathesis 
cup: cup 
gr: gr 
coursity: coursity 
language: language 
trend: trends 
reilly: reilly 
radar: radar 
oreilly: oreilly 
com: com 
redmonk: redmonk 
ranking: rankings 
january: january 
tecosystems: tecosystems 
pdf: pdf 
making: making 
conversation: conversation 
part: part 
bill: bill 
venners: venners 
artima: artima 
summerfield: summerfield 
mark: mark 
rapid: rapid 
gui: gui 
qt: qt 
expressive: expressive 
mean: means 
usually: usually 
write: write 
far: far 
fewer: fewer 
line: lines 
would: would 
required: required 
equivalent: equivalent 
application: application 
written: written 
say: say 
mcconnell: mcconnell 
steve: steve 
complete: complete 
isbn: isbn 
home: home 
page: page 
history: history 
course: course 
eu: eu 
automated: automated 
translation: translation 
documentation: documentation 
doc: docs 
cmd: cmd 
stackoverflow: stackoverflow 
carlie: carlie 
fairchild: fairchild 
stepping: stepping 
benevolent: benevolent 
dictator: dictator 
life: life 
linuxjournal: linuxjournal 
bos: boss 
step: steps 
year: years 
theinquirer: theinquirer 
net: net 
pcsteps: pcsteps 
user: users 
tem: tem 
uoc: uoc 
pep: pep 
guide: guide 
wayback: wayback 
machine: machine 
nikolaos: nikolaos 
sgarbas: sgarbas 
kyriakos: kyriakos 
paliouras: paliouras 
vassilis: vassilis 
koukias: koukias 
michalis: michalis 
work: work 
progress: progress 
introduction: introduction 
computing: computing 
using: using 
based: based 
experiential: experiential 
approach: approach 
ieee: ieee 
engineering: engineering 
education: education 
conference: conference 
educon: educon 
doi: doi 
sc: sc 
cc: cc 
sa: sa 
dave: dave 
kuhlman: kuhlman 
december: december 
book: book 
beginning: beginning 
advancedpython: advancedpython 
exercise: exercises 
abstract: abstract 
learning: learning 
contains: contains 
beginner: beginners 
discussion: discussion 
several: several 
advanced: advanced 
topic: topics 
interest: interest 
programmer: programmers 
workbook: workbook 
lot: lots 
j: j 
guttag: guttag 
gaddi: gaddis 
davinci: davinci 
sch: sch 
chatzipap: chatzipap 
computation: computation 
multimedia: multimedia 
cookbook: cookbook 
pearson: pearson 
custom: custom 
pub: pub 
ubuntu: ubuntu 
informatics: informatics 
pu: pu 
google: google 
en: en 
wikibooks: wikibooks 
curlie: curlie 
power: power 
moodle: moodle 
sepchiou: sepchiou 
wikimedia: wikimedia 
common: commons 
ada: ada 
algol: algol 
apl: apl 
applescript: applescript 
assembly: assembly 
basic: basic 
cobol: cobol 
erlang: erlang 
forth: forth 
fortran: fortran 
go: go 
haskell: haskell 
javascript: javascript 
kotlin: kotlin 
lisp: lisp 
logo: logo 
lua: lua 
ml: ml 
objective: objective 
pascal: pascal 
php: php 
prolog: prolog 
r: r 
rust: rust 
sql: sql 
shell: shell 
simula: simula 
smalltalk: smalltalk 
swift: swift 
visual: visual 
copyleft: copyleft 
aros: aros 
bsd: bsd 
darwin: darwin 
ecos: ecos 
freedos: freedos 
gnu: gnu 
haiku: haiku 
inferno: inferno 
mach: mach 
minix: minix 
opensolaris: opensolaris 
plan: plan 
reactos: reactos 
symbian: symbian 
eclipse: eclipse 
free: free 
gcc: gcc 
gamba: gambas 
llvm: llvm 
netbeans: netbeans 
rose: rose 
mozilla: mozilla 
suite: suite 
firefox: firefox 
thunderbird: thunderbird 
apache: apache 
blender: blender 
freedesktop: freedesktop 
india: india 
latin: latin 
america: america 
fsmi: fsmi 
gnome: gnome 
project: project 
kde: kde 
v: v 
geospatial: geospatial 
initiative: initiative 
freedom: freedom 
conservancy: conservancy 
sourceforge: sourceforge 
xiph: xiph 
xmpp: xmpp 
standard: standards 
artistic: artistic 
lgpl: lgpl 
isc: isc 
mit: mit 
mpl: mpl 
m: ms 
pl: pl 
rl: rl 
zlib: zlib 
fsf: fsf 
approved: approved 
debian: debian 
guideline: guidelines 
binary: binary 
blob: blob 
canonical: canonical 
contributor: contributor 
agreement: agreement 
digital: digital 
right: rights 
management: management 
proliferation: proliferation 
rebranding: rebranding 
proprietary: proprietary 
sco: sco 
trusted: trusted 
viral: viral 
forking: forking 
specification: specification 
promise: promise 
revolution: revolution 
worldcat: worldcat 
lccn: lccn 
sh: sh 
gnd: gnd 
sudoc: sudoc 
bnf: bnf 
newpp: newpp 
limit: limit 
report: report 
parsed: parsed 
cached: cached 
time: time 
cache: cache 
expiry: expiry 
reduced: reduced 
complication: complications 
cpu: cpu 
usage: usage 
second: seconds 
real: real 
preprocessor: preprocessor 
visited: visited 
post: post 
expand: expand 
include: include 
byte: bytes 
template: template 
argument: argument 
highest: highest 
expansion: expansion 
depth: depth 
expensive: expensive 
parser: parser 
unstrip: unstrip 
recursion: recursion 
number: number 
wikibase: wikibase 
entity: entities 
loaded: loaded 
transclusion: transclusion 
call: calls 
total: total 
authority: authority 
control: control 
commonscat: commonscat 
cite: cite 
web: web 
navbox: navbox 
citation: citation 
core: core 
journal: journal 
portal: portal 
bar: bar 
saved: saved 
elwiki: elwiki 
pcache: pcache 
idhash: idhash 
timestamp: timestamp 
revision: revision 
serialized: serialized 
json: json 
oldid: oldid 
webarchive: webarchive 
dmoz: dmoz 
wikidata: wikidata 
