information: information 
security: securities security 
wikipedia: wikipedia 
free: free 
encyclopedia: encyclopedia 
jump: jump 
navigation: navigation 
search: search searches 
protecting: protecting 
mitigating: mitigating 
risk: risks risk 
mw: mw 
parser: parser 
output: output 
sidebar: sidebar 
width: width 
em: em 
float: float 
right: rights right 
clear: clear 
margin: margin 
background: background 
f: f 
fa: fa 
border: border 
px: px 
solid: solid 
aaa: aaa 
padding: padding 
text: text 
align: align 
center: center centers 
line: line 
height: height 
font: font 
size: size 
collapse: collapse 
display: display displays 
table: table tables 
body: bodies body 
skin: skin 
minerva: minerva 
important: important 
subgroup: subgroup 
spacing: spacing 
left: left 
none: none 
outer: outer 
title: title 
weight: weight 
bold: bold 
top: top 
image: image 
caption: caption 
pretitle: pretitle 
heading: heading 
content: content contents 
bottom: bottom 
navbar: navbar 
list: list lists 
c: cs c 
max: max 
mediawiki: mediawiki 
part: parts part 
series: series 
related: related 
category: categories category 
computer: computers computer 
automotive: automotive 
cybercrime: cybercrime 
cybersex: cybersex 
trafficking: trafficking 
fraud: fraud 
cybergeddon: cybergeddon 
cyberterrorism: cyberterrorism 
cyberwarfare: cyberwarfare 
electronic: electronic 
warfare: warfare 
internet: internet 
mobile: mobile 
network: networks network 
copy: copy 
protection: protection protections 
digital: digital 
management: management 
threat: threats threat 
adware: adware 
advanced: advanced 
persistent: persistent 
arbitrary: arbitrary 
code: codes code 
execution: execution 
backdoor: backdoors 
hardware: hardware 
injection: injection 
crimeware: crimeware 
cross: cross 
site: site 
scripting: scripting 
cryptojacking: cryptojacking 
malware: malware 
botnets: botnets 
data: data 
breach: breach breaches 
drive: drive drives 
download: download 
browser: browser 
helper: helper 
object: object objects 
crime: crime 
virus: virus viruses 
scraping: scraping 
denial: denial 
service: services service 
eavesdropping: eavesdropping 
email: emails email 
spoofing: spoofing 
exploit: exploit exploits 
keyloggers: keyloggers 
logic: logic 
bomb: bombs 
time: time times 
fork: fork 
zip: zip 
fraudulent: fraudulent 
dialers: dialers 
payload: payload 
phishing: phishing 
polymorphic: polymorphic 
engine: engine 
privilege: privilege privileges 
escalation: escalation 
ransomware: ransomware 
rootkits: rootkits 
bootkits: bootkits 
scareware: scareware 
shellcode: shellcode 
spamming: spamming 
social: social 
engineering: engineering 
screen: screen 
spyware: spyware 
software: software 
bug: bug bugs 
trojan: trojans trojan 
horse: horses 
remote: remote 
access: access 
vulnerability: vulnerability vulnerabilities 
web: web 
shell: shell shells 
wiper: wiper 
worm: worms 
sql: sql 
rogue: rogue 
zombie: zombie 
defense: defenses defense 
application: applications application 
secure: secure 
coding: coding 
default: default 
design: design 
misuse: misuse 
case: case cases 
control: control controls 
authentication: authentication 
multi: multi 
factor: factor factors 
authorization: authorization authorizations 
antivirus: antivirus 
focused: focused 
operating: operating 
system: system systems 
centric: centric 
obfuscation: obfuscation 
masking: masking 
encryption: encryption 
firewall: firewall firewalls 
intrusion: intrusion 
detection: detection 
host: host hosts 
based: based 
hids: hids 
anomaly: anomaly 
event: events event 
siem: siem 
gateway: gateway 
runtime: runtime 
self: self 
inline: inline 
normal: normal 
boxtext: boxtext 
word: word words 
ul: ul 
block: blocks block 
white: white 
space: space 
nowrap: nowrap 
inherit: inherit 
bracket: brackets 
li: li 
span: span 
abbr: abbr 
decoration: decoration 
mini: mini 
variant: variant 
small: small 
cap: caps 
cursor: cursor 
ct: ct 
full: full 
v: v 
e: e 
sometimes: sometimes 
shortened: shortened 
infosec: infosec 
practice: practice practices 
typically: typically 
involves: involves 
preventing: preventing 
reducing: reducing 
probability: probability 
unauthorized: unauthorized 
inappropriate: inappropriate 
unlawful: unlawful 
use: use 
disclosure: disclosures disclosure 
disruption: disruptions disruption 
deletion: deletion 
corruption: corruption 
modification: modification 
inspection: inspection 
recording: recording 
devaluation: devaluation 
also: also 
action: actions 
intended: intended 
reduce: reduce 
adverse: adverse 
impact: impact impacts 
incident: incident incidents 
protected: protected 
may: may 
take: takes take 
form: forms form 
g: g 
physical: physical 
tangible: tangible 
paperwork: paperwork 
intangible: intangible 
knowledge: knowledge 
primary: primary 
focus: focuses focus 
balanced: balanced 
confidentiality: confidentiality 
integrity: integrity 
availability: availability 
known: known 
cia: cia 
triad: triad 
maintaining: maintaining 
efficient: efficient 
policy: policy policies 
implementation: implementation 
without: without 
hampering: hampering 
organization: organizations organization 
productivity: productivity 
largely: largely 
achieved: achieved 
structured: structured 
process: process processes 
identifying: identifying 
asset: assets asset 
plus: plus 
potential: potential 
evaluating: evaluating 
deciding: deciding 
address: address 
treat: treat 
avoid: avoid 
mitigate: mitigate 
share: shares share 
accept: accept 
mitigation: mitigation 
required: required 
selecting: selecting 
designing: designing 
appropriate: appropriate 
implementing: implementing 
monitoring: monitoring 
activity: activities activity 
making: making 
adjustment: adjustments 
necessary: necessary 
issue: issue issues 
change: changes change 
improvement: improvement 
opportunity: opportunities opportunity 
standardize: standardize 
discipline: discipline disciplines 
academic: academics academic 
professional: professionals professional 
collaborate: collaborate 
offer: offer offers 
guidance: guidance 
industry: industries industry 
standard: standards standard 
password: password passwords 
legal: legal 
liability: liability 
awareness: awareness 
training: training 
forth: forth 
standardization: standardization 
driven: driven 
wide: wide 
variety: variety 
law: law laws 
regulation: regulation regulations 
affect: affect 
accessed: accessed 
processed: processed 
stored: stored 
transferred: transferred 
destroyed: destroyed 
however: however 
within: within 
entity: entity entities 
limited: limited 
effect: effects effect 
culture: cultures culture 
continual: continual 
adopted: adopted 
definition: definitions definition 
overview: overview 
response: responses response 
history: history 
basic: basics basic 
principle: principles principle 
key: key keys 
concept: concept concepts 
non: non 
repudiation: repudiation 
administrative: administrative 
logical: logical 
depth: depth 
classification: classification 
identification: identification 
cryptography: cryptography 
governance: governance 
plan: plan plans 
preparation: preparation 
containment: containment 
eradication: eradication 
recovery: recovery 
lesson: lessons 
learned: learned 
business: businesses business 
continuity: continuity 
source: source sources 
see: see 
reference: references 
reading: reading 
bibliography: bibliography 
external: external 
link: link links 
edit: edit 
attribute: attributes 
quality: qualities quality 
composed: composed 
three: three 
main: main 
portion: portions 
communication: communications communication 
purpose: purpose 
help: help helps 
identify: identify 
apply: apply 
mechanism: mechanisms mechanism 
prevention: prevention 
level: levels level 
layer: layers layer 
personal: personal 
organizational: organizational 
essentially: essentially 
procedure: procedure procedures 
implemented: implemented 
tell: tells tell 
administrator: administrators administrator 
user: users user 
operator: operators operator 
product: products product 
ensure: ensure 
various: various 
suggested: suggested 
summarized: summarized 
different: different 
preservation: preservation 
note: note notes 
addition: addition 
property: properties property 
authenticity: authenticity 
accountability: accountability 
reliability: reliability 
involved: involved 
iso: iso 
iec: iec 
destruction: destruction 
order: order 
provide: provide 
cns: cnss 
ensures: ensures 
authorized: authorized 
accurate: accurate 
complete: complete 
isaca: isaca 
intellectual: intellectual 
organisation: organisation organisations 
pipkin: pipkin 
whose: whose 
job: job 
manage: manage 
cost: cost costs 
mcdermott: mcdermott 
geer: geer 
well: well 
informed: informed 
sense: sense 
assurance: assurance 
balance: balance 
anderson: anderson 
j: j 
minimizes: minimizes 
exposing: exposing 
party: party parties 
venter: venter 
eloff: eloff 
multidisciplinary: multidisciplinary 
area: areas area 
study: studies study 
concerned: concerned 
development: development 
available: available 
type: types type 
technical: technical 
human: human 
oriented: oriented 
keep: keep 
location: location locations 
outside: outside 
perimeter: perimeter 
consequently: consequently 
created: created 
transmitted: transmitted 
categorized: categorized 
corresponding: corresponding 
goal: goals goal 
defined: defined 
set: sets set 
identified: identified 
result: results result 
analysis: analysis 
revised: revised 
periodically: periodically 
adequacy: adequacy 
conformance: conformance 
evolving: evolving 
environment: environment 
currently: currently 
relevant: relevant 
include: include 
privacy: privacy 
trustworthiness: trustworthiness 
auditability: auditability 
cherdantseva: cherdantseva 
hilton: hilton 
resource: resources resource 
using: using 
telecommunication: telecommunications telecommunication 
device: device devices 
mean: mean means 
book: books book 
damage: damage 
theft: theft 
kurose: kurose 
ross: ross 
core: core 
act: acts act 
ensuring: ensuring 
compromised: compromised 
way: way ways 
critical: critical 
arise: arise 
natural: natural 
disaster: disasters disaster 
server: servers server 
malfunction: malfunction 
paper: paper 
operation: operation operations 
still: still 
prevalent: prevalent 
requiring: requiring 
enterprise: enterprise enterprises 
initiative: initiative initiatives 
increasingly: increasingly 
emphasized: emphasized 
dealt: dealt 
technology: technology technologies 
specialist: specialists 
often: often 
worthwhile: worthwhile 
necessarily: necessarily 
home: home 
desktop: desktop 
processor: processor 
memory: memory 
range: range 
networked: networked 
standalone: standalone 
simple: simple 
calculator: calculators 
computing: computing 
smartphones: smartphones 
tablet: tablet 
almost: almost 
always: always 
found: found 
major: major 
establishment: establishment 
due: due 
nature: nature 
value: value 
larger: larger 
responsible: responsible 
keeping: keeping 
company: companies company 
malicious: malicious 
cyber: cyber 
attack: attacks attack 
attempt: attempts attempt 
acquire: acquire 
private: private 
gain: gain 
internal: internal 
field: field fields 
grown: grown 
evolved: evolved 
significantly: significantly 
recent: recent 
year: year years 
many: many 
specialization: specialization 
including: including 
securing: securing 
allied: allied 
infrastructure: infrastructures infrastructure 
database: database databases 
testing: testing 
auditing: auditing 
planning: planning 
record: record records 
discovery: discovery 
forensics: forensics 
citation: citation 
needed: needed 
stable: stable 
employment: employment 
update: update 
percent: percent 
employer: employer employers 
period: period periods 
number: number numbers 
projected: projected 
continuously: continuously 
grow: grow 
annually: annually 
come: come 
common: common commons 
today: today 
identity: identities identity 
equipment: equipment 
sabotage: sabotage 
extortion: extortion 
people: people 
experienced: experienced 
sort: sort 
example: examples example 
extensive: extensive 
someone: someone 
else: else 
usually: usually 
obtain: obtain 
person: person persons 
advantage: advantage 
vital: vital 
becoming: becoming 
fact: fact 
prone: prone 
become: become 
far: far 
desirable: desirable 
amount: amount 
capacity: capacity 
increase: increase increases 
consists: consists 
website: website 
cause: causes cause 
loss: losses loss 
confidence: confidence 
customer: customers 
receive: receive 
payment: payment 
exchange: exchange 
returning: returning 
back: back 
owner: owner 
protect: protect 
one: one 
functional: functional 
precaution: precautions precaution 
conduct: conduct 
periodical: periodical 
employee: employees employee 
called: called 
insider: insider 
government: government governments 
military: military 
corporation: corporation corporations 
financial: financial 
institution: institution institutions 
hospital: hospitals 
profit: profit 
amass: amass 
great: great 
deal: deal 
confidential: confidential 
research: research 
status: status 
finance: finances finance 
new: new 
fall: fall 
hand: hands 
competitor: competitor 
black: black 
hat: hat 
hacker: hackers hacker 
could: could 
suffer: suffer 
widespread: widespread 
irreparable: irreparable 
reputation: reputation 
perspective: perspectives perspective 
must: must 
gordon: gordon 
loeb: loeb 
model: model models 
provides: provides 
mathematical: mathematical 
economic: economic 
approach: approach approaches 
addressing: addressing 
concern: concerns concern 
individual: individuals individual 
significant: significant 
viewed: viewed 
differently: differently 
possible: possible 
implement: implements implement 
safeguard: safeguard safeguards 
countermeasure: countermeasure countermeasures 
eliminate: eliminate 
assign: assign 
transfer: transfer transfers 
place: place 
onto: onto 
another: another 
purchasing: purchasing 
insurance: insurance 
outsourcing: outsourcing 
evaluate: evaluate 
outweighs: outweighs 
since: since 
early: early 
day: days day 
diplomat: diplomats 
commander: commanders 
understood: understood 
correspondence: correspondence 
detecting: detecting 
tampering: tampering 
julius: julius 
caesar: caesars caesar 
credited: credited 
invention: invention 
cipher: cipher 
b: bs b 
prevent: prevent 
secret: secret secrets 
message: message messages 
read: read 
wrong: wrong 
procedural: procedural 
handling: handling 
sensitive: sensitive 
marked: marked 
indicate: indicate 
transported: transported 
trusted: trusted 
guarded: guarded 
strong: strong 
box: box boxes 
postal: postal 
expanded: expanded 
official: official 
intercept: intercept 
decipher: decipher 
reseal: reseal 
letter: letters 
u: us u 
k: k 
office: office 
founded: founded 
mid: mid 
nineteenth: nineteenth 
century: century 
complex: complex 
developed: developed 
allow: allow 
according: according 
degree: degree 
sensitivity: sensitivity 
british: british 
codified: codified 
extent: extent 
publication: publication publications 
section: section sections 
espionage: espionage 
trust: trust 
public: public 
interest: interests interest 
soon: soon 
added: added 
defend: defend 
state: state states 
similar: similar 
passed: passed 
india: india 
indian: indian 
associated: associated 
colonial: colonial 
era: era 
used: used 
crack: crack 
newspaper: newspapers 
opposed: opposed 
raj: raj 
newer: newer 
version: version 
extended: extended 
matter: matters 
first: first 
world: world 
war: war wars 
tier: tier 
communicate: communicate 
front: fronts 
encouraged: encouraged 
greater: greater 
breaking: breaking 
diplomatic: diplomatic 
headquarters: headquarters 
encoding: encoding 
became: became 
sophisticated: sophisticated 
machine: machine machines 
employed: employed 
scramble: scramble 
unscramble: unscramble 
inaugurated: inaugurated 
need: need needs 
appeared: appeared 
ii: iis ii 
volume: volume 
shared: shared 
country: country countries 
second: second seconds 
necessitated: necessitated 
formal: formal 
alignment: alignment 
arcane: arcane 
marking: markings 
handle: handle 
document: documents document 
officer: officers 
rather: rather 
enlisted: enlisted 
troop: troops 
safe: safes safe 
storage: storage 
facility: facilities 
enigma: enigma 
german: german germans 
encrypt: encrypt 
successfully: successfully 
decrypted: decrypted 
alan: alan 
turing: turing 
regarded: regarded 
striking: striking 
creating: creating 
secured: secured 
properly: properly 
failure: failure failures 
follow: follow 
led: led 
greatest: greatest 
intelligence: intelligence 
coup: coups 
capture: capture 
mainframe: mainframe 
connected: connected 
online: online 
cold: cold 
task: task tasks 
easier: easier 
mailing: mailing 
magnetic: magnetic 
tape: tapes 
project: project projects 
agency: agency 
arpa: arpa 
united: united 
department: department departments 
started: started 
researching: researching 
feasibility: feasibility 
trade: trade 
armed: armed 
force: force forces 
arpanet: arpanet 
formulated: formulated 
dr: dr 
larry: larry 
robert: roberts robert 
would: would 
later: later 
evolve: evolve 
element: element elements 
pioneer: pioneer 
metcalfe: metcalfe 
flaw: flaw flaws 
structure: structure 
format: format formats 
lack: lack 
safety: safety 
dial: dial 
connection: connections 
nonexistent: nonexistent 
aside: aside 
effortless: effortless 
phone: phones phone 
problem: problems 
coupled: coupled 
constant: constant 
violation: violation violations 
exponential: exponential 
alluded: alluded 
insecurity: insecurity 
end: end 
twentieth: twentieth 
twenty: twenty 
saw: saw 
rapid: rapid 
advancement: advancements 
smaller: smaller 
powerful: powerful 
le: le less 
expensive: expensive 
made: made 
processing: processing 
reach: reach 
protocol: protocol protocols 
internetwork: internetwork 
tcp: tcp 
ip: ip 
enabled: enabled 
quickly: quickly 
interconnected: interconnected 
growth: growth 
conducted: conducted 
along: along 
numerous: numerous 
occurrence: occurrence occurrences 
international: international 
terrorism: terrorism 
fueled: fueled 
better: better 
method: method methods 
store: store 
transmit: transmit 
emerged: emerged 
sharing: sharing 
poster: poster 
promoting: promoting 
russian: russian 
ministry: ministry 
defence: defence 
heart: heart 
member: members member 
classic: classics classic 
interchangeably: interchangeably 
referred: referred 
literature: literature 
fundamental: fundamentals fundamental 
aspect: aspect aspects 
criterion: criteria 
characteristic: characteristics 
building: building buildings 
debate: debate 
continues: continues 
whether: whether 
sufficient: sufficient 
rapidly: rapidly 
changing: changing 
requirement: requirements requirement 
recommendation: recommendation recommendations 
consider: consider 
expanding: expanding 
intersection: intersections 
relationship: relationship 
proposed: proposed 
pointed: pointed 
fit: fit 
seems: seems 
mentioned: mentioned 
nist: nist 
oecd: oecd 
guideline: guidelines guideline 
nine: nine 
generally: generally 
accepted: accepted 
responsibility: responsibilities responsibility 
ethic: ethics 
democracy: democracy 
assessment: assessments assessment 
reassessment: reassessment 
upon: upon 
derived: derived 
donn: donn 
parker: parker 
alternative: alternative 
six: six 
atomic: atomic 
possession: possession 
utility: utility 
merit: merits 
parkerian: parkerian 
hexad: hexad 
subject: subject 
amongst: amongst 
open: open 
group: group groups 
published: published 
ism: isms ism 
operational: operational 
objective: objectives objective 
compliance: compliance 
dod: dod 
released: released 
tenet: tenets 
cybersecurity: cybersecurity 
susceptibility: susceptibility 
capability: capabilities capability 
neither: neither 
widely: widely 
disclosed: disclosed 
two: two 
interchangeable: interchangeable 
component: component components 
viewer: viewers 
laptop: laptop 
sent: sent 
incorrect: incorrect 
assuring: assuring 
accuracy: accuracy 
completeness: completeness 
entire: entire 
lifecycle: lifecycle 
cannot: cannot 
modified: modified 
undetected: undetected 
manner: manner 
thing: thing things 
referential: referential 
although: although 
special: special 
consistency: consistency 
acid: acid 
transaction: transactions transaction 
incorporate: incorporate 
particular: particular 
kernel: kernel 
function: function functions 
deliberate: deliberate 
accidental: accidental 
aim: aim aims 
compartmentalize: compartmentalize 
adversely: adversely 
succeed: succeed 
infection: infections 
hack: hacks 
broadly: broadly 
commercial: commercial 
touch: touches 
credibility: credibility 
truthfulness: truthfulness 
timeliness: timeliness 
serve: serve 
channel: channels 
functioning: functioning 
correctly: correctly 
high: high 
remain: remain 
power: power 
outage: outages outage 
upgrade: upgrades 
flood: flood 
incoming: incoming 
target: target targets 
forcing: forcing 
shut: shut 
realm: realm 
successful: successful 
program: program programs 
ultimately: ultimately 
able: able 
perform: perform 
stakeholder: stakeholders 
expect: expect 
involve: involve 
topic: topics 
proxy: proxy 
configuration: configuration configurations 
ability: ability 
send: send 
executive: executives 
oftentimes: oftentimes 
understand: understand 
side: side 
look: look 
easy: easy 
fix: fix 
requires: requires 
collaboration: collaboration 
team: team teams 
role: roles role 
mesh: mesh 
provided: provided 
effectively: effectively 
implies: implies 
intention: intention 
fulfill: fulfill 
obligation: obligations 
contract: contract 
deny: deny 
received: received 
cryptographic: cryptographic 
assist: assist 
effort: efforts effort 
transcending: transcending 
instance: instance 
show: show shows 
match: matches match 
signature: signature signatures 
signed: signed 
sender: sender 
thus: thus 
nobody: nobody 
altered: altered 
transit: transit 
alleged: alleged 
return: return returns 
demonstrate: demonstrate 
algorithm: algorithm algorithms 
vulnerable: vulnerable 
flawed: flawed 
allege: allege 
prove: prove 
signing: signing 
fault: fault 
lie: lie 
assertion: assertion assertions 
relieve: relieve 
invalidate: invalidate 
claim: claim 
prof: proves 
repudiate: repudiate 
pre: pre 
requisite: requisites 
hatnote: hatnote 
style: styles style 
italic: italic 
div: div 
article: articles article 
speaking: speaking 
likelihood: likelihood 
something: something 
bad: bad 
happen: happen 
harm: harm 
informational: informational 
weakness: weakness 
endanger: endanger 
anything: anything 
man: man 
creates: creates 
inflict: inflict 
context: context 
possibly: possibly 
lost: lost 
income: income 
life: life lives 
real: real 
certified: certified 
auditor: auditors auditor 
cisa: cisa 
review: review reviews 
manual: manual 
defines: defines 
achieving: achieving 
acceptable: acceptable 
clarification: clarification 
ongoing: ongoing 
iterative: iterative 
repeated: repeated 
indefinitely: indefinitely 
constantly: constantly 
emerge: emerge 
every: every 
choice: choice 
strike: strike strikes 
effectiveness: effectiveness 
furthermore: furthermore 
limitation: limitations 
rare: rare 
specific: specific 
easily: easily 
duplicated: duplicated 
evaluated: evaluated 
remaining: remaining 
residual: residual 
carried: carried 
membership: membership 
vary: vary 
assessed: assessed 
subjective: subjective 
qualitative: qualitative 
opinion: opinions opinion 
reliable: reliable 
dollar: dollar 
figure: figure figures 
historical: historical 
quantitative: quantitative 
shown: shown 
point: points point 
designer: designer 
recommends: recommends 
following: following 
examined: examined 
environmental: environmental 
acquisition: acquisition 
maintenance: maintenance 
regulatory: regulatory 
broad: broad 
term: terms 
estimating: estimating 
print: prints print 
supply: supply supplies 
accident: accidents 
originating: originating 
inside: inside 
calculate: calculate 
exploited: exploited 
select: select 
proportional: proportional 
measure: measure measures 
effective: effective 
discernible: discernible 
given: given 
choose: choose 
relative: relative 
low: low 
frequency: frequency 
leadership: leadership 
buying: buying 
reality: reality 
disputed: disputed 
proper: proper 
initially: initially 
bring: bring 
selection: selection 
fundamentally: fundamentally 
additional: additional 
consist: consist 
approved: approved 
written: written 
framework: framework frameworks 
running: running 
managing: managing 
inform: inform 
run: run runs 
sector: sectors sector 
followed: followed 
card: card 
pci: pci 
ds: dss 
visa: visa 
mastercard: mastercard 
corporate: corporate 
hiring: hiring 
disciplinary: disciplinary 
basis: basis 
manifestation: manifestations 
paramount: paramount 
importance: importance 
monitor: monitor 
frequently: frequently 
overlooked: overlooked 
least: least 
granted: granted 
blatant: blatant 
adhere: adhere 
logging: logging 
window: windows 
surf: surf 
occur: occur 
collect: collect collects 
happens: happens 
duty: duties duty 
promoted: promoted 
position: position 
already: already 
existing: existing 
longer: longer 
work: work works 
door: door doors 
lock: locks lock 
heating: heating 
air: air 
conditioning: conditioning 
smoke: smoke 
fire: fire 
alarm: alarms 
suppression: suppression 
camera: cameras 
barricade: barricades 
fencing: fencing 
guard: guards 
cable: cable 
etc: etc 
separating: separating 
workplace: workplace 
separation: separation 
submits: submits 
request: requests request 
reimbursement: reimbursement 
authorize: authorize 
check: checks check 
programmer: programmer 
separated: separated 
onion: onion 
throughout: throughout 
lifespan: lifespan 
initial: initial 
creation: creation 
final: final 
disposal: disposal 
motion: motion 
rest: rest 
lifetime: lifetime 
pas: pass 
threatened: threatened 
fully: fully 
layering: layering 
overlapping: overlapping 
contrast: contrast 
metal: metal 
chain: chains chain 
famously: famously 
weakest: weakest 
strategy: strategies strategy 
defensive: defensive 
fail: fail 
continue: continue 
recall: recall 
earlier: earlier 
discussion: discussion 
build: build 
conceptualized: conceptualized 
distinct: distinct 
plane: planes 
laid: laid 
insight: insight insights 
gained: gained 
thinking: thinking 
forming: forming 
next: next 
outermost: outermost 
equally: equally 
valid: valid 
valuable: valuable 
good: good goods 
recognizing: recognizing 
defining: defining 
equal: equal 
assigned: assigned 
step: step steps 
senior: senior 
classified: classified 
develop: develop 
describe: describe 
label: labels label 
define: define 
influence: influence 
much: much 
old: old 
obsolete: obsolete 
consideration: considerations consideration 
classifying: classifying 
audit: audit audits 
association: association 
serf: serves 
tool: tool tools 
examine: examine 
managed: managed 
holistically: holistically 
allowing: allowing 
actual: actual 
addressed: addressed 
selected: selected 
depend: depend 
unclassified: unclassified 
unofficial: unofficial 
english: english 
equivalent: equivalents 
sectoral: sectoral 
formation: formations formation 
traffic: traffic 
light: light 
green: green 
amber: amber 
red: red 
partner: partners 
trained: trained 
schema: schema 
reviewed: reviewed 
restricted: restricted 
sophistication: sophistication 
parity: parity 
stronger: stronger 
foundation: foundation 
built: built 
start: start 
considered: considered 
make: makes make 
statement: statement statements 
hello: hello 
name: names name 
john: john 
doe: doe 
true: true 
verify: verify 
claiming: claiming 
really: really 
username: username 
entering: entering 
belongs: belongs 
verifying: verifying 
go: go goes 
bank: banks bank 
withdrawal: withdrawal 
teller: teller 
asks: asks 
photo: photo 
id: ids id 
driver: driver 
license: license 
sure: sure 
printed: printed 
compare: compares 
photograph: photograph 
authenticated: authenticated 
claimed: claimed 
similarly: similarly 
correct: correct 
providing: providing 
evidence: evidence 
know: know 
pin: pin 
mother: mother 
maiden: maiden 
swipe: swipe 
biometrics: biometrics 
palm: palm 
fingerprint: fingerprints 
voice: voice 
retina: retina 
eye: eye 
scan: scans 
usernames: usernames 
served: served 
inadequate: inadequate 
slowly: slowly 
replaced: replaced 
supplemented: supplemented 
determined: determined 
permitted: permitted 
allowed: allowed 
view: views view 
create: create 
delete: delete 
begin: begins 
prescribe: prescribe 
condition: conditions 
configured: configured 
enforce: enforce 
equipped: equipped 
kind: kinds 
even: even 
combination: combination 
discretionary: discretionary 
consolidates: consolidates 
centralized: centralized 
administration: administration 
give: give gives 
creator: creator 
mandatory: mandatory 
denied: denied 
basing: basing 
file: files file 
permission: permissions permission 
unix: unix 
kerberos: kerberos 
radius: radius 
tacacs: tacacs 
router: routers 
enforceable: enforceable 
upheld: upheld 
held: held 
accountable: accountable 
treasury: treasury 
proprietary: proprietary 
failed: failed 
logged: logged 
leave: leave 
trail: trails trail 
talking: talking 
dealing: dealing 
difference: difference differences 
clearance: clearance clearances 
though: though 
exchanged: exchanged 
grant: grant 
accessing: accessing 
supposed: supposed 
directly: directly 
us: uses 
transform: transform 
usable: usable 
render: renders 
unusable: unusable 
anyone: anyone 
encrypted: encrypted 
rendered: rendered 
transformed: transformed 
original: original 
posse: possesses 
decryption: decryption 
either: either 
electronically: electronically 
physically: physically 
useful: useful 
improved: improved 
digest: digest digests 
older: older 
telnet: telnet 
ftp: ftp 
ssh: ssh 
wireless: wireless 
wpa: wpa 
wep: wep 
wired: wired 
itu: itu 
hn: hn 
aes: aes 
x: x 
gnupg: gnupg 
pgp: pgp 
introduce: introduce 
solution: solutions solution 
undergone: undergone 
rigorous: rigorous 
peer: peers peer 
independent: independent 
expert: experts 
length: length 
strength: strength 
weak: weak 
short: short 
produce: produce 
rigor: rigor 
pki: pki 
surround: surround 
reasonable: reasonable 
prudent: prudent 
care: care 
diligence: diligence 
federal: federal 
sentencing: sentencing 
hold: hold 
liable: liable 
failing: failing 
exercise: exercise exercises 
stockholder: stockholders 
expectation: expectation expectations 
accordance: accordance 
described: described 
rule: rule rules 
everything: everything 
done: done 
operate: operate 
sound: sound 
ethical: ethical 
diligent: diligent 
mindful: mindful 
attentive: attentive 
harris: harris 
taken: taken 
continually: continually 
maintained: maintained 
attention: attention 
verified: verified 
measured: measured 
artifact: artifacts 
actually: actually 
maintain: maintain 
practicing: practicing 
applying: applying 
docra: docra 
considers: considers 
affected: affected 
others: others 
presenting: presenting 
burden: burden 
increased: increased 
litigation: litigation 
mission: mission 
institute: institutes institute 
carnegie: carnegie 
mellon: mellon 
university: university 
titled: titled 
governing: governing 
ge: ges 
guide: guide 
leader: leaders 
segregation: segregation 
enforced: enforced 
adequate: adequate 
committed: committed 
staff: staff 
aware: aware 
cycle: cycle 
planned: planned 
measurable: measurable 
audited: audited 
expansion: expansion 
adding: adding 
january: january 
irp: irp 
dictate: dictate 
reaction: reactions reaction 
initiated: initiated 
implication: implications 
knowing: knowing 
local: local 
unique: unique 
skill: skills skill 
lawyer: lawyer 
included: included 
navigate: navigate 
includes: includes 
irt: irt 
penetration: penetration 
track: track 
trend: trends 
modern: modern 
identifies: identifies 
report: report reports 
admin: admin 
notice: notices 
irregularity: irregularities 
investigation: investigation 
launched: launched 
log: log 
crucial: crucial 
updating: updating 
flow: flow flows 
fast: fast 
occurred: occurred 
activated: activated 
phase: phase 
isolate: isolate 
took: took 
limit: limit limits 
scope: scope 
preserve: preserve 
forensically: forensically 
analyzed: analyzed 
containing: containing 
room: room 
segmenting: segmenting 
spread: spread 
removed: removed 
deleting: deleting 
terminating: terminating 
account: accounts account 
require: require 
moving: moving 
completely: completely 
stage: stage 
restored: restored 
future: future 
executing: executing 
gathered: gathered 
decision: decision decisions 
prevented: prevented 
train: train 
admins: admins 
distributed: distributed 
itsm: itsm 
directing: directing 
controlling: controlling 
alteration: alterations 
posed: posed 
improve: improve 
stability: stability 
hinder: hinder 
introduces: introduces 
apparently: apparently 
unexpected: unexpected 
introduced: introduced 
inopportune: inopportune 
disrupt: disrupt 
interfere: interfere 
everyday: everyday 
routine: routine 
predefined: predefined 
reduces: reduces 
overall: overall 
deploying: deploying 
relocating: relocating 
upgrading: upgrading 
pose: pose 
higher: higher 
communicating: communicating 
overseen: overseen 
board: board 
representative: representatives 
networking: networking 
developer: developers developer 
support: support supports 
desk: desk 
facilitated: facilitated 
automated: automated 
documented: documented 
follows: follows 
performs: performs 
undergo: undergo 
preliminary: preliminary 
determine: determine 
requested: requested 
compatible: compatible 
approve: approve 
allocation: allocation 
therefore: therefore 
priority: priority priorities 
might: might 
reject: reject 
best: best 
allocated: allocated 
discovering: discovering 
analyzing: analyzing 
complexity: complexity 
developing: developing 
documenting: documenting 
test: test tests 
tested: tested 
closely: closely 
reflects: reflects 
production: production 
applied: applied 
backout: backout 
schedule: schedule 
scheduling: scheduling 
reviewing: reviewing 
date: date 
conflict: conflicts 
scheduled: scheduled 
communicated: communicated 
remind: remind 
otherwise: otherwise 
appointed: appointed 
post: post 
fails: fails 
drop: drop 
dead: dead 
met: met 
documentation: documentation 
approval: approval 
critique: critique 
postponed: postponed 
particularly: particularly 
backed: backed 
try: try 
encountered: encountered 
greatly: greatly 
success: success 
accomplished: accomplished 
visible: visible 
ops: ops 
handbook: handbook 
itil: itil 
practical: practical 
auditable: auditable 
summary: summary 
bcm: bcm 
arrangement: arrangements 
aiming: aiming 
interruption: interruption 
minimize: minimize 
essential: essential essentials 
current: current 
continuation: continuation 
usual: usual 
going: going 
encompasses: encompasses 
dependency: dependencies 
hence: hence 
specification: specification 
maximum: maximum 
tolerable: tolerable 
architecture: architecture 
resilience: resilience 
avoiding: avoiding 
situation: situation situations 
interrupt: interrupt 
emergency: emergency 
evacuating: evacuating 
premise: premises 
calling: calling 
triage: triage 
invoking: invoking 
rebuilding: rebuilding 
contingency: contingency 
generic: generic 
positively: positively 
whatever: whatever 
occurs: occurs 
configuring: configuring 
backup: backup backups 
duplicating: duplicating 
strengthening: strengthening 
contracting: contracting 
supplier: suppliers 
setting: setting 
allocating: allocating 
fund: fund funds 
prioritization: prioritization 
motivation: motivation 
coordination: coordination 
checking: checking 
maturing: maturing 
continuous: continuous 
learning: learning 
investment: investment 
specified: specified 
measuring: measuring 
reporting: reporting 
parameter: parameters 
conducting: conducting 
invoked: invoked 
whereas: whereas 
minimizing: minimizing 
severity: severity 
drp: drp 
specifically: specifically 
resuming: resuming 
lay: lays 
recover: recover 
ict: ict 
establishing: establishing 
performing: performing 
preparing: preparing 
inventory: inventories 
verification: verification 
lastly: lastly 
ranking: ranking 
endemic: endemic 
surveillance: surveillance 
society: societies society 
partial: partial 
listing: listing 
governmental: governmental 
uk: uk 
provision: provision provisions 
relating: relating 
obtaining: obtaining 
holding: holding 
european: european 
union: union 
directive: directive directives 
eudpd: eudpd 
adopt: adopt 
national: national 
citizen: citizens 
parliament: parliament 
hacking: hacking 
criminal: criminal 
offense: offense 
several: several 
canada: canadas canada 
republic: republic 
ireland: ireland 
drawn: drawn 
inspiration: inspiration 
subsequently: subsequently 
drafting: drafting 
retention: retention 
annulled: annulled 
provider: providers provider 
call: calls call 
month: months 
family: family families 
educational: educational 
ferpa: ferpa 
cfr: cfr 
protects: protects 
student: students student 
education: education 
applies: applies 
school: schools 
applicable: applicable 
parent: parent 
eligible: eligible 
release: release 
examination: examination 
council: council 
ffiec: ffiec 
specifies: specifies 
banking: banking 
health: health 
portability: portability 
hipaa: hipaa 
adoption: adoption 
identifier: identifiers 
additionally: additionally 
gramm: gramm 
leach: leach 
bliley: bliley 
glba: glba 
modernization: modernization 
sarbanes: sarbanes 
oxley: oxley 
sox: sox 
publicly: publicly 
traded: traded 
ass: assess 
annual: annual 
submit: submit 
fiscal: fiscal 
chief: chief 
engage: engage 
attest: attest 
validity: validity 
establishes: establishes 
comprehensive: comprehensive 
enhancing: enhancing 
founding: founding 
brand: brands 
american: american 
express: express 
discover: discover 
jcb: jcb 
worldwide: worldwide 
facilitate: facilitate 
consistent: consistent 
global: global 
multifaceted: multifaceted 
protective: protective 
notification: notification 
california: california 
nonprofit: nonprofits nonprofit 
notify: notify 
consumer: consumer consumers 
unencrypted: unencrypted 
stolen: stolen 
electronics: electronics 
pipeda: pipeda 
promotes: promotes 
commerce: commerce 
collected: collected 
certain: certain 
circumstance: circumstances 
amending: amending 
statutory: statutory 
instrument: instruments 
statute: statutes statute 
revision: revision 
greece: greece 
hellenic: hellenic 
authority: authority 
adae: adae 
describes: describes 
minimum: minimum 
deployed: deployed 
managerial: managerial 
concentrate: concentrates 
around: around 
offered: offered 
greek: greek 
deploy: deploy 
redundant: redundant 
describing: describing 
simply: simply 
idea: ideas 
custom: customs 
behavior: behaviors 
positive: positive 
negative: negative 
cultural: cultural 
segment: segment segments 
towards: towards 
think: think 
feel: feel 
big: big 
roer: roer 
petric: petric 
seven: seven 
dimension: dimensions 
attitude: attitudes 
feeling: feelings 
emotion: emotions 
pertain: pertain 
taking: taking 
direct: direct 
indirect: indirect 
cognition: cognition 
verifiable: verifiable 
belief: beliefs 
regarding: regarding 
efficacy: efficacy 
relation: relation 
belonging: belonging 
adherence: adherence 
existence: existence 
substance: substance 
norm: norms 
perception: perceptions perception 
informally: informally 
deemed: deemed 
deviant: deviant 
hidden: hidden 
unwritten: unwritten 
understanding: understanding 
sustaining: sustaining 
endangering: endangering 
thereby: thereby 
andersson: andersson 
reimers: reimers 
ignore: ignore 
author: author authors 
commented: commented 
never: never 
ending: ending 
evaluation: evaluation 
five: five 
strategic: strategic 
operative: operative 
analyze: analyze 
clustering: clustering 
helpful: helpful 
achieve: achieve 
buy: buy 
feature: feature features 
commitment: commitment 
course: courses 
gauge: gauge 
prior: prior 
consortium: consortium 
coordinated: coordinated 
secretariat: secretariat 
geneva: geneva 
switzerland: switzerland 
largest: largest 
technique: techniques 
division: division 
develops: develops 
metric: metrics 
validation: validation 
publishes: publishes 
custodian: custodian 
fips: fips 
confront: confront 
ietf: ietf 
iab: iab 
isoc: isoc 
comment: comments 
rfcs: rfcs 
rfc: rfc 
forum: forum 
isf: isf 
hundred: hundred 
leading: leading 
manufacturing: manufacturing 
undertakes: undertakes 
advice: advice 
biannual: biannual 
detailed: detailed 
advisory: advisory advisories 
iisp: iisp 
governed: governed 
principal: principal 
advancing: advancing 
professionalism: professionalism 
practitioner: practitioners 
whole: whole 
competency: competencies 
expected: expected 
performance: performance 
renowned: renowned 
bundesamt: bundesamt 
r: r 
sicherheit: sicherheit 
der: der 
informationstechnik: informationstechnik 
bsi: bsi 
grundschutz: grundschutz 
methodology: methodologies methodology 
operated: operated 
baseline: baseline 
catalog: catalogs catalog 
formerly: formerly 
collection: collection 
combating: combating 
cluster: cluster 
september: september 
page: pages page 
introduction: introduction 
aligned: aligned 
standardized: standardized 
indicator: indicators 
headed: headed 
industrial: industrial 
isg: isg 
isi: isi 
col: col 
column: columns column 
dl: dl 
ol: ol 
dd: dd 
break: break 
kill: kill 
certification: certifications certification 
convergence: convergence 
single: single 
sign: sign 
reflist: reflist 
decimal: decimal 
upper: upper 
alpha: alpha 
roman: roman 
lower: lower 
cite: cite 
wrap: wrap 
q: q 
quote: quotes 
color: color 
rgba: rgba 
linear: linear 
gradient: gradient 
transparent: transparent 
url: url 
upload: upload 
wikimedia: wikimedia 
org: org 
svg: svg 
repeat: repeat 
registration: registration 
gray: gray 
alt: alt 
subscription: subscription 
aa: aa 
w: w ws 
icon: icon 
wikisource: wikisource 
logo: logo 
error: errors error 
maint: maint 
kern: kern 
selflink: selflink 
joshi: joshi 
chanchala: chanchala 
singh: singh 
umesh: umesh 
kumar: kumar 
august: august 
journal: journal 
doi: doi 
jisa: jisa 
issn: issn 
sans: sans 
www: www 
retrieved: retrieved 
daniel: daniel 
kent: kent 
titman: titman 
sheridan: sheridan 
market: markets market 
ssrn: ssrn 
cid: cid 
kerstin: kerstin 
fink: fink 
measurement: measurement 
uncertainty: uncertainty 
deutscher: deutscher 
universit: universit 
tsverlag: tsverlag 
isbn: isbn 
oclc: oclc 
keyser: keyser 
tobias: tobias 
toolkit: toolkit 
crc: crc 
press: press 
pp: pp 
danzig: danzig 
richard: richard 
fort: fort 
belvoir: belvoir 
va: va 
lyu: lyu 
lau: lau 
l: l 
proceeding: proceedings 
th: th 
conference: conference 
compsac: compsac 
ieee: ieee 
comput: comput 
soc: soc 
cmpsac: cmpsac 
impedes: impedes 
healthcare: healthcare 
hoboken: hoboken 
nj: nj 
usa: usa 
wiley: wiley 
son: sons 
inc: inc 
p: p 
ch: ch 
lent: lent 
tom: tom toms 
walsh: walsh 
bill: bill 
rethinking: rethinking 
ground: ground 
consensus: consensus 
sustainable: sustainable 
barr: barr 
harbor: harbor 
po: po 
west: west 
conshohocken: conshohocken 
pa: pa 
astm: astm 
stp: stp 
meaning: meaning 
technological: technological 
almeida: almeida 
portela: portela 
ed: eds ed 
igi: igi 
publishing: publishing 
vocabulary: vocabulary 
committee: committee 
ia: ia 
glossary: glossary 
instruction: instruction 
april: april 
york: york 
hewlett: hewlett 
packard: packard 
workshop: workshop 
paradigm: paradigm paradigms 
nspw: nspw 
acm: acm 
h: h 
taxonomy: taxonomy 
gold: gold 
december: december 
looming: looming 
beyond: beyond 
sullivant: sullivant 
elsevier: elsevier 
determination: determination 
informatization: informatization 
samonas: samonas 
cos: coss 
redefining: redefining 
archived: archived 
gartner: gartner 
say: says 
disruptors: disruptors 
impacting: impacting 
kpis: kpis 
october: october 
survey: survey 
ceo: ceos 
begun: begun 
transformation: transformation 
forte: forte 
dario: dario 
programme: programme 
voltage: voltage 
switchgear: switchgear 
controlgear: controlgear 
profile: profiles profile 
bsen: bsen 
fetzer: fetzer 
james: james 
highfill: highfill 
tina: tina 
hossiso: hossiso 
kassu: kassu 
howells: howells 
thomas: thomas 
strassner: strassner 
erich: erich 
young: young 
jeffrey: jeffrey 
november: november 
accounting: accounting 
firm: firm 
heterogeneity: heterogeneity 
cambridge: cambridge 
estimation: estimation 
stochastic: stochastic 
cloud: cloud 
emerging: emerging 
modelling: modelling 
nijmeijer: nijmeijer 
hendrik: hendrik 
synchronization: synchronization 
mechanical: mechanical 
scientific: scientific 
numeric: numeric 
chapter: chapter 
dx: dx 
competence: competence 
qualification: qualifications 
sheet: sheet 
pdf: pdf 
march: march 
ruiqing: ruiqing 
ray: ray 
flexible: flexible 
tb: tb 
rahim: rahim 
noor: noor 
malaysia: malaysia 
rhetoric: rhetoric 
aut: aut 
kramer: kramer 
david: david 
nuclear: nuclear 
warns: warns 
physic: physics 
pt: pt 
edward: edward 
wilding: wilding 
investigating: investigating 
stewart: stewart 
cissp: cissp 
trending: trending 
newest: newest 
attackking: attackking 
seriously: seriously 
anna: anna 
wendel: wendel 
persson: persson 
fredrik: fredrik 
ronnhed: ronnhed 
kerhet: kerhet 
och: och 
nniskan: nniskan 
de: de 
har: har 
rldens: rldens 
starkaste: starkaste 
mur: mur 
men: men 
porten: porten 
st: st 
alltid: alltid 
gl: gl 
nt: nt 
ume: ume 
universitet: universitet 
institutionen: institutionen 
informatik: informatik 
enge: enge 
eric: eric 
stone: stone 
temple: temple 
cell: cell 
shao: shao 
ruodan: ruodan 
skarlicki: skarlicki 
toward: toward 
mistreated: mistreated 
scale: scale 
psyctests: psyctests 
dataset: dataset 
kitchen: kitchen 
julie: julie 
june: june 
courtenay: courtenay 
working: working 
panic: panic 
mental: mental 
routledge: routledge 
cornell: cornell 
france: france 
comparison: comparison 
unincorporated: unincorporated 
basingstoke: basingstoke 
palgrave: palgrave 
macmillan: macmillan 
lawrence: lawrence 
martin: martin 
economics: economics 
cho: cho 
kim: kim 
byung: byung 
khansa: khansa 
lara: lara 
tabitha: tabitha 
july: july 
sixth: sixth 
edition: editions edition 
gillett: gillett 
benefit: benefit 
assessing: assessing 
despite: despite 
austria: austria 
long: long 
live: live 
dramatic: dramatic 
afterlife: afterlife 
bloomsbury: bloomsbury 
suetonius: suetonius 
tranquillus: tranquillus 
gaius: gaius 
oxford: oxford 
simon: simon 
anchor: anchor 
tan: tan 
heng: heng 
chuan: chuan 
vehicular: vehicular 
thesis: thesis 
nanyang: nanyang 
johnson: johnson 
evolution: evolution 
sigint: sigint 
majesty: majesty 
stationery: stationery 
asin: asin 
gyx: gyx 
gx: gx 
willison: willison 
matthew: matthew 
contrasting: contrasting 
viewpoint: viewpoints 
britain: britain 
ruppert: ruppert 
amended: amended 
hastedt: hastedt 
spy: spies 
wiretap: wiretaps 
vol: vol 
abc: abc 
clio: clio 
clayton: clayton 
price: price 
discrimination: discrimination 
anti: anti 
columbia: columbia 
dunn: dunn 
maer: maer 
lucinda: lucinda 
gay: gay 
secrecy: secrecy 
federation: federation 
scientist: scientists 
revival: revivals 
cover: covers 
questioned: questioned 
gajendra: gajendra 
bound: bound 
interrogation: interrogation 
chamber: chamber 
army: army 
negation: negation 
brill: brill 
library: library libraries 
dlws: dlws 
duncanson: duncanson 
dennis: dennis 
french: french 
indochina: indochina 
asian: asian 
affair: affairs 
whitman: whitman 
et: et 
al: al 
mobilizing: mobilizing 
hydro: hydro 
electricity: electricity 
toronto: toronto 
glatthaar: glatthaar 
joseph: joseph 
soldiering: soldiering 
northern: northern 
virginia: virginia 
north: north 
carolina: carolina 
sebag: sebag 
montefiore: montefiore 
battle: battle 
orion: orion 
wisdom: wisdom 
community: communities 
merton: merton 
lutterworth: lutterworth 
ctt: ctt 
cg: cg 
murphy: murphy 
supercomputer: supercomputers 
pim: pim 
ldrd: ldrd 
brief: brief 
usg: usg 
edu: edu 
walking: walking 
delft: delft 
graphic: graphics 
denardis: denardis 
leeuw: leeuw 
bergstra: bergstra 
perrin: perrin 
chad: chad 
sandhu: sandhu 
ravi: ravi 
jajodia: jajodia 
sushil: sushil 
relational: relational 
four: four 
auerbach: auerbach 
stoneburner: stoneburner 
hayden: hayden 
feringa: feringa 
csrc: csrc 
gov: gov 
sp: sp 
ra: ra 
neumann: neumann 
n: n 
statland: statland 
webb: webb 
bureau: bureau 
gssp: gssp 
trip: trip 
abilene: abilene 
slade: slade 
rob: rob 
ic: ics ic 
blog: blog 
aceituno: aceituno 
vicente: vicente 
maturity: maturity 
february: february 
george: george 
cybenko: cybenko 
hughes: hughes 
jeff: jeff 
innovation: innovation 
teplow: teplow 
lily: lily 
client: client clients 
falling: falling 
myth: myths 
chart: chart 
continuum: continuum 
net: net 
beckers: beckers 
pattern: pattern patterns 
springer: springer 
springerreference: springerreference 
berlin: berlin 
heidelberg: heidelberg 
verlag: verlag 
andress: andress 
theory: theory 
syngress: syngress 
boritz: boritz 
efrim: efrim 
accinf: accinf 
hryshko: hryshko 
occupation: occupation 
land: land 
construction: construction 
tactical: tactical 
humanitarian: humanitarian 
herald: herald 
jurisprudence: jurisprudence 
bonn: bonn 
oh: oh 
pevnev: pevnev 
fan: fan 
lejun: lejun 
wang: wang 
yuanzhuo: yuanzhuo 
cheng: cheng 
xueqi: xueqi 
jinming: jinming 
jin: jin 
shuyuan: shuyuan 
sec: sec 
mk: mk 
video: video 
spie: spie 
optic: optics 
photonics: photonics 
graduate: graduates 
electric: electric 
resulting: resulting 
boston: boston 
edison: edison 
osti: osti 
loukas: loukas 
oke: oke 
comjnl: comjnl 
bxp: bxp 
clinical: clinical 
qeios: qeios 
dine: dine 
ohta: ohta 
mai: mai 
fujii: fujii 
takeo: takeo 
cooperative: cooperative 
sensing: sensing 
spectrum: spectrum 
improving: improving 
symposium: symposium 
dynamic: dynamics dynamic 
dyspan: dyspan 
blum: blum 
dan: dan 
rational: rational 
berkeley: berkeley 
ca: ca 
apress: apress 
mccarthy: mccarthy 
bidgoli: bidgoli 
interconnection: interconnection 
christofori: christofori 
ralf: ralf 
julio: julio 
rondo: rondo 
meta: meta 
wilhelm: wilhelm 
atkins: atkins 
walnut: walnut 
cbor: cbor 
cose: cose 
structural: structural 
petrochemical: petrochemical 
sodjahin: sodjahin 
amos: amos 
champagne: champagne 
claudia: claudia 
coggins: coggins 
frank: frank 
gillet: gillet 
roland: roland 
lagging: lagging 
extra: extra 
score: scores 
reynolds: reynolds 
folate: folate 
bmj: bmj 
pmc: pmc 
pmid: pmid 
randall: randall 
cbo: cbo 
grama: grama 
jones: jones 
bartlett: bartlett 
cannon: cannon 
fourth: fourth 
kadlec: kadlec 
jaroslav: jaroslav 
dimensional: dimensional 
modeling: modeling 
dpm: dpm 
perfect: perfect 
fear: fear 
deloitte: deloitte 
suffers: suffers 
serious: serious 
hit: hit 
detail: details 
equifax: equifax 
yahoo: yahoo 
spagnoletti: spagnoletti 
paolo: paolo 
resca: resca 
duality: duality 
fighting: fighting 
predictable: predictable 
unpredictable: unpredictable 
yusoff: yusoff 
hashim: hashim 
yusof: yusof 
mohd: mohd 
radzuan: radzuan 
hse: hse 
harsh: harsh 
spe: spe 
m: ms 
baxter: baxter 
wesley: wesley 
sold: sold 
ottawa: ottawa 
downtown: downtown 
valorized: valorized 
urban: urban 
carleton: carleton 
etd: etd 
souza: souza 
andr: andr 
lynch: lynch 
anthony: anthony 
mutual: mutual 
kiountouzis: kiountouzis 
kokolakis: kokolakis 
facing: facing 
london: london 
chapman: chapman 
hall: hall 
ltd: ltd 
newsome: newsome 
sage: sage 
mattord: mattord 
cengage: cengage 
fabric: fabrics 
adhesive: adhesives 
theatrical: theatrical 
illustrated: illustrated 
theatre: theatre 
reason: reason 
unsafe: unsafe 
contribution: contribution 
boca: boca 
raton: raton 
fl: fl 
zhuang: zhuang 
haifeng: haifeng 
chen: chen 
yu: yu 
sheng: sheng 
xianfu: xianfu 
hong: hong 
lili: lili 
gao: gao 
ruilan: ruilan 
xiaofen: xiaofen 
prognostic: prognostic 
gene: gene 
peerj: peerj 
supp: supp 
standaert: standaert 
ethgen: ethgen 
emerson: emerson 
co: co 
jval: jval 
grp: grp 
canopy: canopies 
reinforced: reinforced 
plastic: plastics 
performer: performer 
depending: depending 
gary: gary 
goguen: goguen 
alice: alice 
alexis: alexis 
oppression: oppression 
freedom: freedom 
zoccali: zoccali 
carmine: carmine 
mallamaci: mallamaci 
francesca: francesca 
tripepi: tripepi 
giovanni: giovanni 
guest: guest 
editor: editor 
rajiv: rajiv 
agarwal: agarwal 
cardiovascular: cardiovascular 
medication: medication 
seminar: seminars seminar 
dialysis: dialysis 
mapping: mapping 
occupational: occupational 
ergonomics: ergonomics 
demers: demers 
lev: lev 
conversation: conversations 
multiple: multiple 
appendix: appendix 
superior: superior 
conjunction: conjunction 
ransome: ransome 
misra: misra 
emir: emir 
astra: astra 
ex: ex 
trove: trove 
drury: drury 
pbpo: pbpo 
chb: chb 
silverman: silverman 
arnold: arnold 
exit: exit 
interview: interviews 
jom: jom 
bibcode: bibcode 
pharmacist: pharmacists 
pharmaceutical: pharmaceutical 
pj: pj 
matrix: matrix 
resident: residents 
jama: jama 
aggregating: aggregating 
interdependency: interdependencies 
xhr: xhr 
hq: hq 
kakareka: kakareka 
vacca: vacca 
nd: nd 
duke: duke 
howard: howard 
vertical: vertical 
disparity: disparities 
vision: vision 
script: scripts 
metabolomics: metabolomics 
durum: durum 
wheat: wheat 
ac: ac acs 
jafc: jafc 
electrical: electrical 
relay: relays 
dibattista: dibattista 
reimer: reimer 
stat: stat 
michael: michael 
masucci: masucci 
biondi: biondi 
piera: piera 
brauwer: brauwer 
maarten: maarten 
bunce: bunce 
supplemental: supplemental 
combined: combined 
alphabetical: alphabetical 
megan: megan 
vers: vers 
sung: sung 
class: classes class 
directory: directory directories 
jim: jim 
bayuk: bayuk 
axelrod: axelrod 
schutzer: schutzer 
artech: artech 
house: house 
welcome: welcome 
age: age 
overload: overload 
crook: crooks 
exposure: exposure 
override: override 
aihce: aihce 
aiha: aiha 
bmi: bmis 
mcauliffe: mcauliffe 
leo: leo 
safeguarding: safeguarding 
quarterly: quarterly 
khairuddin: khairuddin 
ismail: ismail 
sidek: sidek 
shahrul: shahrul 
naim: naim 
abdul: abdul 
majeed: majeed 
anwar: anwar 
razman: razman 
azraai: azraai 
puzi: puzi 
asmarani: asmarani 
ahmad: ahmad 
hazlina: hazlina 
md: md 
science: science sciences 
fig: fig 
almehmadi: almehmadi 
abdulaziz: abdulaziz 
el: el 
khatib: khatib 
khalil: khalil 
sin: sin 
pei: peiss 
kathy: kathy 
mind: mind 
hunter: hunters 
oso: oso 
fugini: fugini 
martella: martella 
petri: petri 
compliant: compliant 
driving: driving 
licence: licence 
omar: omar 
santos: santos 
ccna: ccna 
cert: cert 
cisco: cisco 
abingdon: abingdon 
taylor: taylor 
francis: francis 
season: season 
illinois: illinois 
soil: soil 
horizon: horizons 
sh: sh 
leech: leech 
sock: socks 
kirk: kirk 
wall: wall 
christine: christine 
seller: seller 
activist: activist 
worker: worker workers 
dewi: dewi 
mila: mila 
nurmala: nurmala 
perbandingan: perbandingan 
kinerja: kinerja 
kriya: kriya 
organik: organik 
syariah: syariah 
mandiri: mandiri 
nisbah: nisbah 
jurnal: jurnal 
perbankan: perbankan 
jn: jn 
vile: vile 
amendment: amendment 
street: street 
nw: nw 
suite: suite 
washington: washington 
dc: dc 
cq: cq 
said: said 
ghost: ghost 
south: south 
ctv: ctv 
wgjjv: wgjjv 
bacigalupo: bacigalupo 
sonny: sonny 
dixon: dixon 
linda: linda 
gubbins: gubbins 
kucharski: kucharski 
adam: adam 
drewe: drewe 
julian: julian 
contact: contact 
igelnik: igelnik 
boris: boris 
zurada: zurada 
jacek: jacek 
efficiency: efficiency 
scalability: scalability 
computational: computational 
intellect: intellect 
superbill: superbill 
joe: joe 
kissell: kissell 
smart: smart 
queensland: queensland 
announced: announced 
livermore: livermore 
laboratory: laboratory 
energy: energy 
ergonomic: ergonomic 
panel: panel 
interface: interface 
dept: dept 
lee: lee 
paul: paul 
charming: charming 
trailblazing: trailblazing 
mainstream: mainstream 
biometric: biometric 
marriage: marriage 
remains: remains 
partnership: partnership 
among: among 
couple: couples 
akpeninor: akpeninor 
ohwofasa: ohwofasa 
bloomington: bloomington 
authorhouse: authorhouse 
richards: richards 
otp: otp 
schumacher: schumacher 
dietmar: dietmar 
surface: surface 
geochemical: geochemical 
exploration: exploration 
exhibition: exhibition 
barcelona: barcelona 
spain: spain 
seg: seg 
meeting: meeting 
abstract: abstract abstracts 
geophysicist: geophysicists 
petroleum: petroleum 
geologist: geologists 
ice: ice 
ctvqc: ctvqc 
liang: liang 
zhang: zhang 
yang: yang 
han: han 
zhihui: zhihui 
quantitatively: quantitatively 
across: across 
sere: sere 
subunit: subunits 
glutamate: glutamate 
transporter: transporter 
eaac: eaac 
homotrimer: homotrimer 
independently: independently 
bi: bi 
elli: ellis 
ormrod: ormrod 
jeanne: jeanne 
psychology: psychology 
teaching: teaching 
pearson: pearson 
belim: belim 
bogachenko: bogachenko 
kabanov: kabanov 
arxiv: arxiv 
material: material 
fixing: fixing 
medicine: medicines 
regime: regime 
hrd: hrd 
salazar: salazar 
mary: mary 
uncertain: uncertain 
precautionary: precautionary 
aaohn: aaohn 
censor: censors 
pournelle: pournelle 
jerry: jerry 
missing: missing 
empty: empty 
easttom: easttom 
william: william 
elliptic: elliptic 
curve: curve 
cham: cham 
follman: follman 
rebecca: rebecca 
seeking: seeking 
mentoring: mentoring 
iconference: iconference 
ischools: ischools 
hdl: hdl 
wei: weiss wei 
jason: jason 
java: java 
extension: extensions 
bider: bider 
rsa: rsa 
sha: sha 
noh: noh 
jaewon: jaewon 
jeehyeong: jeehyeong 
kwon: kwon 
giwon: giwon 
sunghyun: sunghyun 
scheme: scheme 
psk: psk 
asia: asia 
icce: icce 
van: van 
buren: buren 
roy: roy 
base: bases 
sigsac: sigsac 
bonneau: bonneau 
rent: rent 
lecture: lecture 
coleman: coleman 
heather: heather 
andron: andron 
gi: gis 
marxan: marxan 
multiobjective: multiobjective 
ocean: ocean 
earth: earth 
esri: esri 
giri: giri 
debasis: debasis 
barua: barua 
prithayan: prithayan 
srivastava: srivastava 
jana: jana 
biswapati: biswapati 
cryptosystem: cryptosystem 
isa: isa 
conf: conf 
vallabhaneni: vallabhaneni 
shon: shon 
exam: exam 
emeryville: emeryville 
mcgraw: mcgraw 
hill: hill 
osborne: osborne 
boncardo: boncardo 
jean: jean 
claude: claude 
milner: milner 
mallarm: mallarm 
nothing: nothing 
edinburgh: edinburgh 
hedge: hedge 
gaylord: gaylord 
diagnostic: diagnostic 
general: general 
practioner: practioner 
sic: sic 
nose: nose 
southern: southern 
medical: medical 
renes: renes 
landschappen: landschappen 
maas: maas 
en: en 
peel: peel 
een: een 
toegepast: toegepast 
historisch: historisch 
geografisch: geografisch 
onderzoek: onderzoek 
het: het 
streekplangebied: streekplangebied 
noord: noord 
midden: midden 
limburg: limburg 
eisma: eisma 
brook: brook 
minding: minding 
previous: previous 
scholarship: scholarship 
acprof: acprof 
lundgren: lundgren 
regina: regina 
last: last 
jensen: jensen 
talbot: talbot 
sutton: sutton 
cherney: cherney 
adrian: adrian 
erika: erika 
fda: fda 
antidepressant: antidepressant 
kid: kids 
news: news 
auckland: auckland 
cressida: cressida 
advance: advance 
dementia: dementia 
medlaw: medlaw 
fwx: fwx 
takach: takach 
westby: westby 
allen: allen 
fowler: fowler 
kevvie: kevvie 
bisogni: bisogni 
fabio: fabio 
proving: proving 
turbo: turbo 
iltanget: iltanget 
iltanet: iltanet 
leonard: leonard 
will: wills 
leighton: leighton 
landscape: landscape 
clogging: clogging 
thf: thf 
oprd: oprd 
turner: turner 
tim: tim 
beginning: beginning 
began: began 
story: story 
erlanger: erlanger 
leon: leon 
pc: pc 
magazine: magazine 
belgrade: belgrade 
absolute: absolute 
radical: radical 
manipulation: manipulation 
borgstr: borgstr 
pernilla: pernilla 
strengbom: strengbom 
joachim: joachim 
viketoft: viketoft 
maria: maria 
bommarco: bommarco 
riccardo: riccardo 
mixed: mixed 
signficant: signficant 
penfold: penfold 
copying: copying 
ecdl: ecdl 
module: module 
onur: onur 
gumus: gumus 
asp: asp 
platform: platform 
apps: apps 
packt: packt 
trouble: trouble 
shooting: shooting 
film: film films 
restores: restores 
restoration: restoration 
liao: liao 
qi: qi 
zhen: zhen 
striegel: striegel 
aaron: aaron 
game: games game 
theoretical: theoretical 
nilufer: nilufer 
boeckman: boeckman 
philip: philip 
greenwald: greenwald 
von: von 
bismarck: bismarck 
twelfth: twelfth 
europe: europe 
overcoming: overcoming 
challenge: challenge challenges 
practising: practising 
spending: spending 
growing: growing 
financing: financing 
ying: ying 
chinese: chinese 
informatics: informatics 
kampfner: kampfner 
roberto: roberto 
jenner: jenner 
henk: henk 
ecotoxicological: ecotoxicological 
leaching: leaching 
pulverized: pulverized 
coal: coal 
ash: ashes 
pathology: pathology 
wilby: wilby 
orr: orr 
hedger: hedger 
forrow: forrow 
blackmore: blackmore 
climate: climate 
delivery: delivery 
water: water 
envint: envint 
campbell: campbell 
koppelman: koppelman 
multicultural: multicultural 
diverse: diverse 
america: america 
allyn: allyn 
bacon: bacon 
scene: scene 
sensational: sensational 
shot: shot 
binay: binay 
mahto: mahto 
tulsi: tulsi 
kumari: kumari 
vinita: vinita 
binod: binod 
deepmala: deepmala 
quackery: quackery 
fatal: fatal 
medico: medico 
priest: priest 
sally: sally 
jfr: jfr 
inspector: inspector 
deficiency: deficiencies 
los: los 
alamo: alamos 
elaine: elaine 
abolhassan: abolhassan 
ferri: ferri 
scheer: scheer 
dawson: dawson 
chris: chris 
mccormick: mccormick 
douglas: douglas 
maximize: maximize 
wealth: wealth 
schuler: schuler 
rainer: rainer 
tractable: tractable 
polynomial: polynomial 
computable: computable 
distribution: distribution 
excel: excel 
do: dos 
lan: lans 
blackwell: blackwell 
kirchmer: kirchmer 
mathias: mathias 
excellence: excellence 
josh: josh 
stieber: stieber 
liu: liu 
supervisor: supervisor 
bayesian: bayesian 
scoring: scoring 
computerized: computerized 
simulation: simulation 
kavanagh: kavanagh 
backstage: backstage 
bureaucracy: bureaucracy 
hawaii: hawaii 
braun: braun 
promise: promise 
pencil: pencil 
ordinary: ordinary 
extraordinary: extraordinary 
longitudinal: longitudinal 
carolyn: carolyn 
ingraham: ingraham 
patricia: patricia 
ban: ban 
legislating: legislating 
bureaucratic: bureaucratic 
civil: civil 
reform: reform 
sn: sns 
gev: gev 
ring: ring 
agricultural: agricultural 
virtual: virtual 
icbmei: icbmei 
unmanaged: unmanaged 
lead: leads 
bragg: bragg 
steven: steven 
hrmid: hrmid 
gad: gad 
spatial: spatial 
rowan: rowan 
answering: answering 
eb: eb 
biswas: biswas 
margaret: margaret 
asit: asit 
climatic: climatic 
food: food 
agriculture: agriculture 
editorial: editorial 
sustainability: sustainability 
emerald: emerald 
xv: xv 
xvii: xvii 
mirage: mirage 
poem: poems 
sj: sj 
bell: bell 
marvin: marvin 
antioch: antioch 
jstor: jstor 
mazikana: mazikana 
tapiwa: tapiwa 
past: past 
present: present 
miss: miss 
kennedy: kennedy 
zimbabwe: zimbabwe 
ramanadham: ramanadham 
venkata: venkata 
vemuri: vemuri 
privatisation: privatisation 
anonymous: anonymous 
realistic: realistic 
rheology: rheology 
numerical: numerical 
performed: performed 
gmd: gmd 
rc: rc 
lientz: lientz 
lasting: lasting 
smeets: smeets 
peter: peter 
expeditie: expeditie 
agroparken: agroparken 
ontwerpend: ontwerpend 
naar: naar 
metropolitane: metropolitane 
landbouw: landbouw 
duurzame: duurzame 
ontwikkeling: ontwikkeling 
kekes: kekes 
justice: justice 
hard: hard 
question: questions 
forrester: forrester 
kellie: kellie 
macroeconomic: macroeconomic 
composition: composition 
labor: labor 
choudhury: choudhury 
gagan: gagan 
rappaport: rappaport 
stephen: stephen 
demand: demand 
collision: collision 
sigcomm: sigcomm 
crinson: crinson 
mark: mark 
lovely: lovely 
signified: signified 
stirling: stirling 
nostalgia: nostalgia 
cot: cot 
ahwidy: ahwidy 
mansour: mansour 
pemberton: pemberton 
lyn: lyn 
lnhs: lnhs 
ehealth: ehealth 
ageing: ageing 
scitepress: scitepress 
mortimer: mortimer 
paradise: paradise 
soriani: soriani 
marco: marco 
faculty: faculty 
sars: sars 
cov: cov 
expand: expand 
vaccination: vaccination 
immunology: immunology 
frampton: frampton 
map: map 
hess: hess 
harrison: harrison 
craft: craft 
walter: walter 
hiller: hiller 
jack: jack 
mccluskey: mccluskey 
coordinating: coordinating 
draft: draft 
combat: combat 
battalion: battalion 
itpi: itpi 
wayback: wayback 
wikisummaries: wikisummaries 
bigelow: bigelow 
michelle: michelle 
himss: himss 
disruptive: disruptive 
hoanh: hoanh 
chu: chu 
thai: thai 
aid: aid 
integrated: integrated 
cailup: cailup 
regional: regional 
irrigated: irrigated 
quan: quan 
lo: lo 
phung: phung 
hiep: hiep 
region: region 
mekong: mekong 
delta: delta 
vietnam: vietnam 
itc: itc 
hibberd: hibberd 
definitive: definitive 
hotchkiss: hotchkiss 
stuart: stuart 
proquest: proquest 
ebook: ebook 
central: central 
asm: asm 
sfa: sfa 
clemens: clemens 
myriad: myriad 
genetics: genetics 
goatcher: goatcher 
genevieve: genevieve 
crisis: crisis 
road: road 
thousand: thousand 
oak: oaks 
tradeoff: tradeoffs 
radio: radio 
blundell: blundell 
iee: iee 
transport: transport 
king: king 
jonathan: jonathan 
phillips: phillips 
brenda: brenda 
landahl: landahl 
schnurr: schnurr 
stephanie: stephanie 
discourse: discourse 
humour: humour 
sample: sample 
violence: violence 
chandos: chandos 
congress: congress 
honolulu: honolulu 
ahupua: ahupua 
hawai: hawai 
engineer: engineers 
standing: standing 
intituled: intituled 
llc: llc 
lehtonen: lehtonen 
lasse: lasse 
genetic: genetic 
legislation: legislation 
archive: archives 
dharmapala: dharmapala 
dhammika: dhammika 
hines: hines 
tax: tax 
haven: havens 
participation: participation 
rate: rates 
risen: risen 
labour: labour 
slowed: slowed 
ec: ec 
eur: eur 
lex: lex 
defamation: defamation 
alabama: alabama 
nclb: nclb 
achievement: achievement 
psycextra: psycextra 
karen: karen 
gottschang: gottschang 
china: china 
prc: prc 
scholarly: scholarly 
academy: academy 
booklet: booklet 
amy: amy 
alase: alase 
abayomi: abayomi 
oluwatosin: oluwatosin 
sized: sized 
northeastern: northeastern 
solis: solis 
lupita: lupita 
portland: portland 
honor: honors 
abbreviation: abbreviations 
acronym: acronyms 
gloss: gloss 
breakdown: breakdown 
ravallion: ravallion 
shaohua: shaohua 
welfare: welfare 
poverty: poverty 
legislature: legislatures 
stein: stein 
schaberg: schaberg 
biddle: biddle 
laura: laura 
answer: answer 
hart: hart 
promote: promote 
queen: queen 
printer: printer 
slr: slr 
canadian: canadian 
minister: minister 
werner: werner 
gazette: gazette 
guise: guise 
preston: preston 
kai: kai 
gregor: gregor 
cltre: cltre 
akhtar: akhtar 
salman: salman 
barretto: barretto 
secondary: secondary 
mar: mar 
description: description 
inted: inted 
schlienger: schlienger 
teufel: teufel 
african: african 
saicsit: saicsit 
ejc: ejc 
refbegin: refbegin 
hanging: hanging 
indent: indent indents 
sc: sc 
issa: issa 
dhillon: dhillon 
lambo: lambo 
dustin: dustin 
cdr: cdr 
julia: julia 
addison: addison 
krutz: krutz 
ronald: ronald 
russell: russell 
dean: dean 
vine: vines 
prep: prep 
indianapolis: indianapolis 
layton: layton 
timothy: timothy 
mcnab: mcnab 
sebastopol: sebastopol 
reilly: reilly 
peltier: peltier 
gregory: gregory 
gurpreet: gurpreet 
ny: ny 
herbert: herbert 
medium: media 
explained: explained 
iw: iws 
navbox: navbox 
sizing: sizing 
auto: auto 
inner: inner 
abovebelow: abovebelow 
fdfdfd: fdfdfd 
tr: tr 
ccf: ccf 
ddf: ddf 
ff: ff 
odd: odd 
hlist: hlist 
td: td 
template: template 
roughly: roughly 
circuit: circuit 
peripheral: peripheral 
large: large 
integration: integration 
chip: chip 
socs: socs 
consumption: consumption 
automation: automation 
acceleration: acceleration 
embedded: embedded 
dependability: dependability 
scheduler: scheduler 
interpreter: interpreter 
middleware: middleware 
notation: notations 
programming: programming 
language: language 
compiler: compiler 
domain: domain 
repository: repository 
variable: variable 
deployment: deployment 
computation: computation 
automaton: automata 
computability: computability 
semantics: semantics 
algorithmic: algorithmic 
randomized: randomized 
geometry: geometry 
mathematics: mathematics 
discrete: discrete 
statistic: statistics 
geographic: geographic 
multimedia: multimedia 
mining: mining 
marketing: marketing 
retrieval: retrieval 
interaction: interaction 
ubiquitous: ubiquitous 
visualization: visualization 
accessibility: accessibility 
concurrency: concurrency 
concurrent: concurrent 
parallel: parallel 
multithreading: multithreading 
multiprocessing: multiprocessing 
artificial: artificial 
representation: representation 
reasoning: reasoning 
philosophy: philosophy 
supervised: supervised 
unsupervised: unsupervised 
reinforcement: reinforcement 
animation: animation 
rendering: rendering 
unit: unit 
compression: compression 
chemistry: chemistry 
biology: biology 
art: art 
voting: voting 
outline: outline 
wikiproject: wikiproject 
newpp: newpp 
parsed: parsed 
cached: cached 
cache: cache 
expiry: expiry 
reduced: reduced 
false: false 
complication: complications 
cpu: cpu 
usage: usage 
preprocessor: preprocessor 
visited: visited 
node: node 
count: count 
byte: bytes 
argument: argument 
highest: highest 
unstrip: unstrip 
recursion: recursion 
lua: lua 
datawrapper: datawrapper 
scribunto: scribunto 
luasandboxcallback: luasandboxcallback 
callparserfunction: callparserfunction 
gsub: gsub 
recursiveclone: recursiveclone 
find: find 
preprocess: preprocess 
getallexpandedarguments: getallexpandedarguments 
wikibase: wikibase 
loaded: loaded 
transclusion: transclusion 
total: total 
sfn: sfn 
saved: saved 
enwiki: enwiki 
pcache: pcache 
idhash: idhash 
canonical: canonical 
timestamp: timestamp 
serialized: serialized 
json: json 
oldid: oldid 
webarchive: webarchive 
wikidata: wikidata 
unsourced: unsourced 
potentially: potentially 
dated: dated 
menu: menu 
