andrew: andrew 
jackson: jackson jacksons 
presidency: presidency 
fact: facts fact 
child: children 
biography: biography 
skip: skip 
main: main 
content: content 
people: peoples people 
nostalgia: nostalgia 
celebrity: celebrity 
history: history 
culture: culture 
crime: crime 
scandal: scandal 
video: video videos 
contact: contact 
u: us u 
advertise: advertise 
privacy: privacy 
notice: notice 
term: term terms 
use: use 
copyright: copyright 
policy: policies policy 
ad: ad 
choice: choices 
accessibility: accessibility 
support: support 
setting: settings 
february: february 
subscribe: subscribe 
newsletter: newsletter 
photo: photo 
universal: universal 
archive: archive 
image: images 
group: group 
via: via 
getty: getty 
quick: quick 
name: name 
birth: birth 
date: date 
march: march 
death: death deaths 
june: june 
know: know 
president: president presidents 
joined: joined 
military: military 
fight: fight 
revolutionary: revolutionary 
war: war 
age: age 
first: first firsts 
ride: ride 
train: train 
hometown: hometown 
waxhaws: waxhaws 
border: border 
north: north 
carolina: carolinas carolina 
south: south 
commander: commander 
chief: chief 
whose: whose 
exact: exact 
state: state states 
unknown: unknown 
place: place 
davidson: davidson 
county: county 
tennessee: tennessee 
nickname: nickname 
old: old 
hickory: hickory 
vice: vice 
john: john 
c: c 
calhoun: calhoun 
duel: duel 
related: related 
cite: cite 
page: page 
quote: quotes 
man: man 
worth: worth 
salt: salt 
stick: stick 
belief: believes 
right: right rights 
take: takes 
slightly: slightly 
better: better 
acknowledge: acknowledge 
instantly: instantly 
without: without 
reservation: reservation 
error: error 
general: general 
government: government 
encroaches: encroaches 
upon: upon 
proportion: proportion 
impair: impair 
power: power 
detract: detract 
ability: ability 
fulfill: fulfill 
purpose: purposes 
creation: creation 
seen: seen 
waged: waged 
knife: knife 
tomahawk: tomahawk 
held: held 
head: heads 
woman: women 
peaceable: peaceable 
citizen: citizens 
murdered: murdered 
time: time times 
make: makes make 
resistance: resistance 
must: must 
victorious: victorious 
conquer: conquer 
men: men 
owe: owe 
nothing: nothing 
chance: chance 
midst: midst 
victory: victory 
still: still 
mindful: mindful 
due: due 
humanity: humanity 
high: high 
standing: standing 
attempt: attempt attempts 
trample: trample 
weak: weak 
fittest: fittest 
object: objects 
example: example 
punishment: punishment 
great: great 
protect: protect 
poor: poor 
humble: humble 
require: require 
arm: arm arms 
shield: shield 
law: law laws 
individual: individual 
refuse: refuses 
defend: defend 
called: called 
deserves: deserves 
slave: slaves slave 
punished: punished 
enemy: enemy 
country: country 
friend: friend 
foe: foe 
die: die 
last: last 
ditch: ditch 
would: would 
yield: yield 
foot: foot 
see: see 
union: union 
disunited: disunited 
obedience: obedience 
order: orders order 
discipline: discipline 
effort: efforts 
vain: vain 
brave: brave 
inattentive: inattentive 
duty: duty 
little: little 
coward: coward 
desert: deserts 
hour: hour 
danger: danger 
instrumental: instrumental 
deliverance: deliverance 
greatest: greatest 
blessing: blessing 
heaven: heaven 
could: could 
confer: confer 
long: long 
administered: administered 
good: good 
regulated: regulated 
secures: secures 
person: person 
property: property 
liberty: liberty 
conscience: conscience 
press: press 
defending: defending 
station: station 
occupy: occupy 
deep: deep 
sense: sense 
arduous: arduous 
responsibility: responsibilities 
strong: strong 
distrust: distrust 
obeyed: obeyed 
call: call 
one: one 
courage: courage 
majority: majority 
bank: bank banks 
trying: trying 
kill: kill 
elevate: elevate 
gun: guns gun 
lower: lower 
publish: publish 
nov: nov 
comment: comment 
seventh: seventh 
united: united 
known: known 
founding: founding 
democratic: democratic 
party: party 
lawyer: lawyer 
landowner: landowner 
xa: xa 
became: became 
national: national 
hero: hero 
defeating: defeating 
british: british 
battle: battle 
new: new 
orleans: orleans 
elected: elected 
destroyed: destroyed 
second: second 
founded: founded 
supported: supported 
instituted: instituted 
resulted: resulted 
forced: forced 
migration: migration 
native: native 
american: americans american 
died: died 
early: early 
life: life lives 
born: born 
elizabeth: elizabeth 
hutchinson: hutchinson 
scot: scots 
irish: irish 
colonist: colonists 
emigrated: emigrated 
ireland: ireland 
though: though 
birthplace: birthplace 
presumed: presumed 
uncle: uncles 
house: house houses 
remote: remote 
region: region 
straddle: straddles 
location: location 
since: since 
precise: precise 
yet: yet 
surveyed: surveyed 
came: came 
three: three 
week: weeks 
sudden: sudden 
father: father 
growing: growing 
poverty: poverty 
wilderness: wilderness 
received: received 
erratic: erratic 
education: education 
year: years year 
older: older 
brother: brother brothers 
hugh: hugh 
stono: stono 
ferry: ferry 
future: future 
local: local 
militia: militia 
served: served 
patriot: patriot 
courier: courier 
captured: captured 
along: along 
robert: robert 
left: left 
permanent: permanent 
scar: scar 
imprisonment: imprisonment 
officer: officer 
gashed: gashed 
hand: hand 
slashed: slashed 
face: face 
sword: sword 
young: young 
boy: boy 
refused: refused 
polish: polish 
redcoat: redcoat 
boot: boots 
captivity: captivity 
contracted: contracted 
smallpox: smallpox 
recover: recover 
orphaned: orphaned 
day: days day 
authority: authorities authority 
released: released 
prisoner: prisoner 
exchange: exchange 
arranged: arranged 
mother: mother 
cholera: cholera 
nursed: nursed 
sick: sick 
injured: injured 
soldier: soldiers 
family: family 
member: member members 
led: led 
lifelong: lifelong 
antipathy: antipathy 
raised: raised 
began: began 
studying: studying 
salisbury: salisbury 
late: late 
teen: teens 
admitted: admitted 
bar: bar 
soon: soon 
appointed: appointed 
prosecuting: prosecuting 
attorney: attorney 
western: western 
district: district 
area: area 
part: part 
moved: moved 
frontier: frontier 
settlement: settlement 
nashville: nashville 
eventually: eventually 
wealthy: wealthy 
money: money 
accumulated: accumulated 
thriving: thriving 
practice: practice 
convention: convention 
established: established 
constitution: constitution 
representative: representatives representative 
senate: senate 
following: following 
resigned: resigned 
serving: serving 
eight: eight 
month: months month 
circuit: circuit 
judge: judge 
superior: superior 
court: court 
position: position 
career: career 
although: although 
lacked: lacked 
experience: experience 
major: major 
troop: troops 
five: five 
campaign: campaign 
allied: allied 
creek: creek 
indian: indian indians 
massacred: massacred 
hundred: hundreds 
settler: settlers 
fort: fort 
mims: mims 
present: present 
alabama: alabama 
culminated: culminated 
horseshoe: horseshoe 
bend: bend 
killing: killing 
warrior: warriors 
eventual: eventual 
procurement: procurement 
million: million 
acre: acres 
land: land lands 
georgia: georgia 
success: success 
promoted: promoted 
specific: specific 
instruction: instructions 
force: forces force 
spanish: spanish 
territory: territory territories 
florida: florida 
outpost: outpost 
pensacola: pensacola 
november: november 
pursuing: pursuing 
skirmish: skirmishes 
december: december 
two: two 
side: sides 
clashed: clashed 
january: january 
outnumbered: outnumbered 
nearly: nearly 
unexpected: unexpected 
engagement: engagement 
dubbed: dubbed 
thanks: thanks 
congress: congress 
gold: gold 
medal: medal 
also: also 
popular: popular 
among: among 
said: said 
tough: tough 
wood: wood 
battlefield: battlefield 
earning: earning 
given: given 
command: command 
army: army 
southern: southern 
division: division 
ordered: ordered 
back: back 
service: service 
seminole: seminole 
end: end 
perhaps: perhaps 
exceeding: exceeding 
invaded: invaded 
controlled: controlled 
st: st 
mark: mark 
executed: executed 
subject: subjects 
secretly: secretly 
assisting: assisting 
overthrew: overthrew 
west: west 
governor: governor 
jos: jos 
xe: xe 
masot: masot 
adam: adams 
oni: onis 
treaty: treaty treaties 
action: actions 
drew: drew 
diplomatic: diplomatic 
rebuke: rebuke 
spain: spain 
many: many 
cabinet: cabinet 
james: james 
monroe: monroe 
censure: censure 
secretary: secretary 
quincy: quincy 
defense: defense 
ceded: ceded 
post: post 
several: several 
senator: senator 
exploit: exploits 
made: made 
rising: rising 
political: political 
star: star 
legislature: legislature 
nominated: nominated 
boost: boost 
credential: credentials 
ran: ran 
election: election 
faction: factions 
rallied: rallied 
around: around 
x: x 
pennsylvania: pennsylvania 
vote: vote votes 
candidate: candidate 
gained: gained 
electoral: electoral 
college: college 
threw: threw 
speaker: speaker 
henry: henry 
clay: clay 
finished: finished 
fourth: fourth 
pledged: pledged 
primary: primary 
opponent: opponents opponent 
emerged: emerged 
accepted: accepted 
defeat: defeat 
named: named 
backer: backers 
decried: decried 
saw: saw 
backroom: backroom 
deal: deal 
corrupt: corrupt 
bargain: bargain 
bruising: bruising 
presidential: presidential 
running: running 
mate: mate 
landslide: landslide 
executive: executive 
resided: resided 
outside: outside 
either: either 
massachusetts: massachusetts 
virginia: virginia 
invite: invite 
public: public 
attend: attend 
inauguration: inauguration 
ball: ball 
white: white 
quickly: quickly 
earned: earned 
popularity: popularity 
crowd: crowd 
arrived: arrived 
large: large 
furniture: furniture 
dish: dishes 
broken: broken 
jostled: jostled 
another: another 
get: get 
look: look 
event: event 
king: king 
mob: mob 
accomplishment: accomplishments 
negative: negative 
reaction: reaction 
decision: decisions decision 
nomination: nomination 
next: next 
split: split 
republican: republican 
grassroots: grassroots 
supporter: supporters supporter 
democrat: democrats 
form: form 
nicknamed: nicknamed 
jackass: jackass 
moniker: moniker 
took: took 
liking: liking 
much: much 
decided: decided 
symbol: symbol 
donkey: donkey 
represent: represent 
later: later 
become: become 
emblem: emblem 
veto: veto 
becoming: becoming 
submit: submit 
making: making 
assume: assume 
prior: prior 
rejected: rejected 
bill: bills bill 
believed: believed 
unconstitutional: unconstitutional 
set: set 
precedent: precedent 
wielding: wielding 
pen: pen 
matter: matter 
upset: upset 
result: result results 
giving: giving 
elect: elect 
abolishing: abolishing 
garnering: garnering 
campaigning: campaigning 
corruption: corruption 
widely: widely 
replace: replace 
incumbent: incumbent 
officeholder: officeholders 
spoil: spoils 
system: system 
feat: feat 
involved: involved 
theoretically: theoretically 
private: private 
corporation: corporation 
actually: actually 
sponsored: sponsored 
monopoly: monopoly 
elitist: elitist 
institution: institutions institution 
manipulated: manipulated 
paper: paper 
wielded: wielded 
economy: economy 
fostered: fostered 
seeking: seeking 
central: central 
issue: issue 
passed: passed 
charter: charter 
july: july 
vetoed: vetoed 
backed: backed 
advancement: advancement 
expense: expense 
read: read 
bella: bella 
hadid: hadid 
sadie: sadie 
alexander: alexander 
adrienne: adrienne 
kennedy: kennedy 
view: views 
percent: percent 
fizzled: fizzled 
shuttered: shuttered 
faced: faced 
unlikely: unlikely 
passage: passage 
federal: federal 
tariff: tariff tariffs 
favored: favored 
northern: northern 
manufacturer: manufacturers 
resolution: resolution 
declaring: declaring 
measure: measures 
null: null 
void: void 
even: even 
threatened: threatened 
secession: secession 
principle: principle 
nullification: nullification 
notion: notion 
secede: secede 
enforce: enforce 
already: already 
replaced: replaced 
york: york 
martin: martin 
van: van 
buren: buren 
former: former 
ticket: ticket 
protested: protested 
resign: resign 
office: office 
within: within 
compromise: compromise 
included: included 
modest: modest 
reduction: reduction 
provision: provision 
empowered: empowered 
armed: armed 
necessary: necessary 
crisis: crisis 
averted: averted 
foreshadowed: foreshadowed 
civil: civil 
decade: decades 
target: target 
assassination: assassination 
leaving: leaving 
memorial: memorial 
congressman: congressman 
inside: inside 
capitol: capitol 
deranged: deranged 
painter: painter 
richard: richard 
lawrence: lawrence 
pointed: pointed 
single: single 
shot: shot 
pistol: pistol 
failed: failed 
shoot: shoot 
pulled: pulled 
misfired: misfired 
infuriated: infuriated 
charged: charged 
shooter: shooter 
hammered: hammered 
cane: cane 
bystander: bystanders 
subdued: subdued 
attempted: attempted 
assassin: assassin 
english: english 
heir: heir 
throne: throne 
owed: owed 
massive: massive 
amount: amount 
found: found 
guilty: guilty 
reason: reason 
insanity: insanity 
confined: confined 
rest: rest 
controversial: controversial 
trail: trail 
tear: tears 
despite: despite 
controversy: controversies 
particularly: particularly 
troubling: troubling 
aspect: aspect 
dealing: dealings 
signed: signed 
implemented: implemented 
removal: removal 
act: act 
gave: gave 
tribe: tribe tribes 
displacement: displacement 
mississippi: mississippi 
river: river 
return: return 
ancestral: ancestral 
homeland: homelands 
stood: stood 
violated: violated 
seized: seized 
nine: nine 
guaranteed: guaranteed 
cherokee: cherokees cherokee 
supreme: supreme 
ruled: ruled 
case: cases 
tribal: tribal 
brokered: brokered 
vacate: vacate 
arkansas: arkansas 
agreement: agreement 
relocation: relocation 
westward: westward 
estimated: estimated 
claimed: claimed 
approximately: approximately 
starvation: starvation 
exposure: exposure 
illness: illness 
dred: dred 
scott: scott 
roger: roger 
taney: taney 
initial: initial 
justice: justice 
marshall: marshall 
subsequently: subsequently 
approved: approved 
went: went 
best: best 
infamous: infamous 
declared: declared 
african: african 
legal: legal 
file: file 
suit: suit 
stated: stated 
forbid: forbid 
slavery: slavery 
go: go 
swear: swear 
abraham: abraham 
lincoln: lincoln 
formed: formed 
coalesced: coalesced 
adopting: adopting 
anti: anti 
monarchist: monarchists 
england: england 
whig: whig 
protest: protest 
autocratic: autocratic 
win: win 
however: however 
successor: successor 
ready: ready 
crater: crater 
benefit: benefit 
common: common 
allowed: allowed 
speculator: speculators 
buy: buy 
huge: huge 
swath: swaths 
drive: drive 
price: prices 
artificially: artificially 
taken: taken 
financial: financial 
loss: loss 
devalued: devalued 
note: notes 
issued: issued 
specie: specie 
circular: circular 
required: required 
payment: payment 
silver: silver 
meet: meet 
demand: demand 
fail: fail 
ensuing: ensuing 
panic: panic 
devastated: devastated 
course: course 
wife: wife 
met: met 
rachel: rachel 
donelson: donelson 
robards: robards 
unhappily: unhappily 
married: married 
separated: separated 
captain: captain 
lewis: lewis 
divorce: divorce 
officially: officially 
complete: complete 
brought: brought 
light: light 
couple: couple 
legally: legally 
remarried: remarried 
accused: accused 
bigamy: bigamy 
willingness: willingness 
engage: engage 
attacker: attackers 
reputation: reputation 
quarrelsome: quarrelsome 
incident: incident 
challenged: challenged 
accuser: accuser 
charles: charles 
dickinson: dickinson 
wounded: wounded 
chest: chest 
ground: ground 
fired: fired 
round: round 
mortally: mortally 
carried: carried 
bullet: bullets bullet 
subsequent: subsequent 
never: never 
biological: biological 
adopted: adopted 
son: son sons 
including: including 
pair: pair 
infant: infant 
orphan: orphans 
theodore: theodore 
lyncoya: lyncoya 
dead: dead 
jr: jr 
severn: severn 
heart: heart 
attack: attack 
blamed: blamed 
stress: stress 
caused: caused 
nasty: nasty 
buried: buried 
christmas: christmas 
eve: eve 
completing: completing 
returned: returned 
cause: cause 
lead: lead 
poisoning: poisoning 
remained: remained 
plantation: plantation 
garden: garden 
beloved: beloved 
continues: continues 
regarded: regarded 
influential: influential 
well: well 
aggressive: aggressive 
ardent: ardent 
governmental: governmental 
change: change 
prominent: prominent 
lasting: lasting 
hermitage: hermitage 
acquired: acquired 
expansive: expansive 
near: near 
outset: outset 
enslaved: enslaved 
worked: worked 
cotton: cotton 
labored: labored 
field: fields 
trump: trump 
predecessor: predecessors 
th: th 
donald: donald 
hung: hung 
portrait: portrait 
ironically: ironically 
behind: behind 
honor: honor 
navajo: navajo 
code: code 
talker: talkers 
assisted: assisted 
marine: marines 
world: world 
ii: ii 
transmitting: transmitting 
encrypted: encrypted 
message: messages 
language: language 
fighting: fighting 
tv: tv 
mini: mini 
bio: bio 
pushed: pushed 
politics: politics 
madison: madison 
shaping: shaping 
pg: pg 
ok: ok 
george: george 
washington: washington 
check: check 
strive: strive 
accuracy: accuracy 
fairness: fairness 
something: something 
citation: citation 
information: information 
article: article 
title: title 
author: author 
com: com 
editor: editors 
website: website 
url: url 
access: access 
publisher: publisher 
e: e 
television: television 
network: networks 
updated: updated 
original: original 
published: published 
april: april 
receive: receive 
story: stories 
shaped: shaped 
sign: sign 
johnson: johnson 
succeeded: succeeded 
impeached: impeached 
continental: continental 
america: america 
thomas: thomas 
jefferson: jefferson 
wrote: wrote 
declaration: declaration 
independence: independence 
completed: completed 
louisiana: louisiana 
purchase: purchase 
activist: activist 
movement: movement 
alongside: alongside 
luther: luther 
mayor: mayor 
atlanta: atlanta 
ambassador: ambassador 
nation: nations 
jesse: jesse 
leader: leader 
baptist: baptist 
minister: minister 
politician: politician 
twice: twice 
cuomo: cuomo 
mario: mario 
news: news 
anchor: anchor 
chris: chris 
formerly: formerly 
hud: hud 
michael: michael 
multi: multi 
talented: talented 
musical: musical 
entertainer: entertainer 
enjoyed: enjoyed 
chart: chart 
topping: topping 
solo: solo 
artist: artist 
selling: selling 
album: albums 
thriller: thriller 
number: number 
hit: hits 
bad: bad 
wall: wall 
dwight: dwight 
eisenhower: eisenhower 
atom: atoms 
peace: peace 
assembly: assembly 
ease: ease 
cold: cold 
tension: tensions 
jimmie: jimmie 
lee: lee 
killed: killed 
trooper: trooper 
inspired: inspired 
demonstration: demonstration 
voting: voting 
loading: loading 
logo: logo 
registered: registered 
trademark: trademarks 
llc: llc 
close: close 
