kirsten: kirsten 
gillibrand: gillibrand 
u: us u 
senator: senators senator 
representative: representatives representative 
biography: biography 
skip: skip 
main: main 
content: content 
people: people 
nostalgia: nostalgia 
celebrity: celebrity 
history: history 
culture: culture 
crime: crimes crime 
scandal: scandal 
video: video 
contact: contact 
advertise: advertise 
privacy: privacy 
notice: notice 
term: terms 
use: use 
copyright: copyright 
policy: policy 
ad: ad 
choice: choices 
accessibility: accessibility 
support: support 
setting: settings 
february: february 
subscribe: subscribe 
newsletter: newsletter 
quick: quick 
fact: facts fact 
name: name 
occupation: occupation 
birth: birth 
date: date 
december: december 
age: age 
education: education 
dartmouth: dartmouth 
college: colleges college 
university: universities university 
california: california 
los: los 
angeles: angeles 
place: place 
albany: albany 
new: new 
york: york 
aka: aka 
rutnik: rutnik 
maiden: maiden 
elizabeth: elizabeth 
full: full 
zodiac: zodiac 
sign: sign 
sagittarius: sagittarius 
early: early 
family: family 
life: life lives 
schooling: schooling 
house: house 
senate: senate 
progressive: progressive 
conservative: conservative 
politics: politics 
cite: cite 
page: page 
quote: quotes 
mother: mothers mother 
amazing: amazing 
woman: woman women 
extremely: extremely 
strong: strong 
independent: independent 
mind: mind 
different: different 
one: one 
friend: friends 
partner: partners 
died: died 
aid: aids 
affected: affected 
man: man 
interesting: interesting 
engaging: engaging 
always: always 
superkind: superkind 
handsome: handsome 
men: men 
ever: ever 
met: met 
loss: loss 
young: young 
girl: girl 
see: see 
someone: someone 
die: die 
congress: congress 
mean: means 
diverse: diverse 
view: views 
represent: represent 
wider: wider 
swath: swath 
electorate: electorate 
bring: bring 
experience: experiences 
perspective: perspective perspectives 
bear: bear 
decision: decision 
making: making 
truly: truly 
believe: believe 
elected: elected 
better: better 
outcome: outcomes 
everyone: everyone 
slightly: slightly 
straighter: straighter 
arrow: arrow 
ok: ok 
massive: massive 
kiss: kiss 
as: ass 
lived: lived 
positive: positive 
reinforcement: reinforcement 
look: look 
sexual: sexual 
assault: assault assaults 
military: military 
campus: campuses campus 
institution: institutions institution 
propping: propping 
favored: favored 
person: person 
star: star 
student: student 
close: close 
rank: ranks 
protect: protect 
status: status 
quo: quo 
process: process 
victim: victim 
blame: blame 
undermine: undermine 
trying: trying 
speak: speak 
truth: truth 
power: power 
dream: dream 
big: big 
embrace: embrace 
ambition: ambitions 
afraid: afraid 
done: done 
way: way 
might: might 
great: great 
goal: goal 
would: would 
agree: agree 
broken: broken 
need: need 
actual: actual 
population: population 
consensus: consensus 
builder: builders 
listen: listen 
le: less 
ego: ego 
driven: driven 
partisan: partisan 
really: really 
percent: percent 
whole: whole 
dynamic: dynamic 
change: change 
analysis: analysis 
frustration: frustration 
frame: frame 
somehow: somehow 
judged: judged 
want: want 
something: something 
supposed: supposed 
first: first 
opposed: opposed 
provide: provide 
child: children 
go: go 
work: work 
every: every 
day: day 
loving: loving 
part: part 
lot: lot 
must: must 
publish: publish 
mar: mar 
comment: comment 
lawyer: lawyer 
politician: politician 
served: served 
born: born 
grew: grew 
political: political 
influenced: influenced 
spirit: spirit 
grandmother: grandmother 
seat: seat 
democrat: democrat democrats 
traditionally: traditionally 
republican: republican 
region: region 
appointed: appointed 
hillary: hillary 
clinton: clinton 
resigned: resigned 
achieved: achieved 
victory: victory 
reelection: reelection 
went: went 
release: release 
non: non 
fiction: fiction 
sideline: sidelines 
solidified: solidified 
staunch: staunch 
proponent: proponent 
reform: reform 
handling: handling 
among: among 
announce: announce 
candidacy: candidacy 
presidential: presidential 
election: election 
dropping: dropping 
race: race 
august: august 
household: household 
free: free 
thinker: thinkers 
maternal: maternal 
dorothea: dorothea 
polly: polly 
noonan: noonan 
major: major 
influence: influence 
advising: advising 
mayor: mayor 
erastus: erastus 
corning: corning 
ii: ii 
organizing: organizing 
state: state states 
legislature: legislature 
secretary: secretary secretaries 
action: action 
pursued: pursued 
career: career 
law: law laws 
also: also 
became: became 
black: black 
belt: belt 
karate: karate 
father: father 
douglas: douglas 
worked: worked 
lobbyist: lobbyist 
using: using 
nickname: nickname 
tina: tina 
attended: attended 
prep: prep 
school: school 
emma: emma 
willard: willard 
going: going 
faced: faced 
still: still 
sexist: sexist 
atmosphere: atmosphere 
decade: decade 
ivy: ivy 
league: league 
gone: gone 
coed: coed 
majored: majored 
asian: asian 
study: studies 
abroad: abroad 
china: china 
interviewed: interviewed 
dalai: dalai 
lama: lama 
graduated: graduated 
magna: magna 
cum: cum 
laude: laude 
earn: earn 
degree: degree 
legal: legal 
firm: firm 
entering: entering 
world: world 
inspired: inspired 
word: words 
time: time 
corporate: corporate 
attorney: attorney 
special: special 
counsel: counsel 
department: department 
housing: housing 
urban: urban 
development: development 
took: took 
surname: surname 
marrying: marrying 
british: british 
venture: venture 
capitalist: capitalist 
jonathan: jonathan 
two: two 
campaigned: campaigned 
running: running 
democratic: democratic 
ticket: ticket 
incumbent: incumbent 
john: john 
e: e 
sweeney: sweeney 
area: area 
upstate: upstate 
tended: tended 
vote: vote 
cemented: cemented 
standing: standing 
community: community 
based: based 
campaigning: campaigning 
resulted: resulted 
landslide: landslide 
january: january 
governor: governor 
david: david 
paterson: paterson 
fill: fill 
left: left 
vacant: vacant 
accepted: accepted 
position: position 
president: president 
barack: barack 
obama: obama 
newly: newly 
formed: formed 
cabinet: cabinet 
thus: thus 
becoming: becoming 
youngest: youngest 
member: member 
record: record 
caused: caused 
described: described 
centrist: centrist 
leaning: leanings 
supporter: supporter 
gay: gay 
right: right rights 
advocating: advocating 
sex: sex 
marriage: marriage 
repeal: repeal 
ask: ask 
tell: tell 
thereby: thereby 
allowing: allowing 
citizen: citizens 
serve: serve 
openly: openly 
improved: improved 
healthcare: healthcare 
benefit: benefits 
worker: workers 
agricultural: agricultural 
committee: committee 
fought: fought 
food: food 
stamp: stamp 
reduction: reductions 
end: end 
amnesty: amnesty 
illegal: illegal 
immigrant: immigrants 
received: received 
endorsement: endorsements 
national: national 
rifle: rifle 
association: association 
later: later 
softened: softened 
stance: stance 
immigration: immigration 
started: started 
favor: favor 
gun: gun 
control: control 
known: known 
transparency: transparency 
sunlight: sunlight 
report: report 
publishes: publishes 
meet: meets 
politically: politically 
welcomed: welcomed 
colleague: colleagues 
call: call 
case: cases 
wendy: wendy 
long: long 
hence: hence 
retaining: retaining 
since: since 
made: made 
headline: headlines 
seeking: seeking 
create: create 
around: around 
within: within 
specifically: specifically 
called: called 
commander: commanders 
longer: longer 
supervise: supervise 
related: related 
court: court 
martial: martial 
proceeding: proceedings 
rape: rape 
handled: handled 
outside: outside 
purview: purview 
general: general 
judicial: judicial 
system: system 
march: march 
justice: justice 
improvement: improvement 
act: act 
supported: supported 
bipartisan: bipartisan 
show: show 
force: force 
number: numbers 
sufficient: sufficient 
overcome: overcome 
filibuster: filibuster 
another: another 
xa: xa 
following: following 
year: year 
group: group 
proposed: proposed 
accountability: accountability 
safety: safety 
aim: aims 
decrease: decrease 
incident: incidents 
thorough: thorough 
regulation: regulations 
read: read 
next: next 
bella: bella 
hadid: hadid 
sadie: sadie 
alexander: alexander 
adrienne: adrienne 
kennedy: kennedy 
released: released 
bestselling: bestselling 
raise: raise 
voice: voice 
recount: recounts 
ascension: ascension 
offer: offers 
governmental: governmental 
affair: affairs 
bid: bid 
presidency: presidency 
prior: prior 
donald: donald 
trump: trump 
morality: morality 
late: late 
began: began 
speaking: speaking 
harassment: harassment 
charge: charges 
enveloping: enveloping 
figure: figures 
entertainment: entertainment 
november: november 
said: said 
bill: bill 
admitting: admitting 
monica: monica 
lewinsky: lewinsky 
angering: angering 
former: former 
ally: allies 
camp: camp 
minnesota: minnesota 
al: al 
franken: franken 
step: step 
multiple: multiple 
accusation: accusations 
misconduct: misconduct 
enough: enough 
wrote: wrote 
facebook: facebook 
country: country 
sent: sent 
clear: clear 
message: message 
kind: kind 
mistreatment: mistreatment 
society: society 
acceptable: acceptable 
stepping: stepping 
aside: aside 
let: let 
else: else 
shortly: shortly 
afterward: afterward 
growing: growing 
chorus: chorus 
calling: calling 
resign: resign 
allegation: allegations 
true: true 
form: form 
punched: punched 
back: back 
via: via 
twitter: twitter 
lightweight: lightweight 
flunky: flunky 
come: come 
office: office 
begging: begging 
campaign: campaign 
contribution: contributions 
ago: ago 
anything: anything 
criticized: criticized 
congressional: congressional 
leader: leaders leader 
anti: anti 
measure: measures 
omnibus: omnibus 
spending: spending 
signed: signed 
aimed: aimed 
overhaul: overhaul 
side: sides 
aisle: aisle 
saw: saw 
outdated: outdated 
claim: claims 
capitol: capitol 
hill: hill 
appalled: appalled 
leadership: leadership 
removed: removed 
provision: provisions 
last: last 
minute: minute 
finally: finally 
brought: brought 
reporting: reporting 
x: x 
c: c 
begs: begs 
question: question 
female: female 
presented: presented 
letter: letter 
majority: majority 
mitch: mitch 
mcconnell: mcconnell 
minority: minority 
chuck: chuck 
schumer: schumer 
legislation: legislation 
complaint: complaint 
survivor: survivors 
bravely: bravely 
forward: forward 
share: share 
story: stories 
light: light 
widespread: widespread 
discrimination: discrimination 
continue: continue 
throughout: throughout 
allow: allow 
perpetrator: perpetrators 
hide: hide 
behind: behind 
old: old 
candidate: candidate 
appearing: appearing 
stephen: stephen 
colbert: colbert 
declared: declared 
launching: launching 
exploratory: exploratory 
run: run 
white: white 
united: united 
mom: mom 
fight: fight 
kid: kids 
hard: hard 
told: told 
despite: despite 
high: high 
profile: profile 
launch: launch 
failed: failed 
gain: gain 
significant: significant 
traction: traction 
month: months 
ahead: ahead 
leaving: leaving 
well: well 
frontrunners: frontrunners 
joe: joe 
biden: biden 
warren: warren 
kamala: kamala 
harris: harris 
bernie: bernie 
sander: sanders 
debate: debate 
june: june 
failing: failing 
qualify: qualify 
third: third 
announced: announced 
check: check 
strive: strive 
accuracy: accuracy 
fairness: fairness 
citation: citation 
information: information 
article: article 
title: title 
author: author 
com: com 
editor: editors 
website: website 
url: url 
access: access 
publisher: publisher 
television: television 
network: networks 
updated: updated 
april: april 
original: original 
published: published 
receive: receive 
shaped: shaped 
introduced: introduced 
federally: federally 
decriminalize: decriminalize 
regulate: regulate 
marijuana: marijuana 
taking: taking 
pot: pot 
controlled: controlled 
substance: substances 
determine: determine 
simply: simply 
thing: thing 
andrew: andrew 
cuomo: cuomo 
th: th 
son: son 
mario: mario 
brother: brother 
news: news 
anchor: anchor 
chris: chris 
formerly: formerly 
hud: hud 
american: american 
lady: lady 
win: win 
public: public 
become: become 
nominee: nominee 
party: party 
nancy: nancy 
pelosi: pelosi 
speaker: speaker 
rahm: rahm 
emanuel: emanuel 
chief: chief 
staff: staff 
chicago: chicago 
cory: cory 
booker: booker 
best: best 
newark: newark 
junior: junior 
jersey: jersey 
joseph: joseph 
p: p 
iii: iii 
famed: famed 
dynasty: dynasty 
latest: latest 
retiring: retiring 
barney: barney 
frank: frank 
massachusetts: massachusetts 
ran: ran 
nomination: nomination 
geraldine: geraldine 
ferraro: ferraro 
vice: vice 
platform: platform 
loading: loading 
logo: logo 
registered: registered 
trademark: trademarks 
llc: llc 
