doctype: doctype 
html: html 
public: public 
w: w 
c: c 
dtd: dtd 
xhtml: xhtml 
strict: strict 
en: en 
body: body 
margin: margin 
top: top 
important: important 
padding: padding 
min: min 
width: width 
px: px 
wm: wm 
rw: rw 
iframe: iframe 
id: id 
donato: donato 
src: src 
platform: platform 
wb: wb 
referer: referer 
web: web 
archive: archives archive 
org: org 
python: python 
net: net 
crew: crew 
mwh: mwh 
hack: hacks 
objectthink: objectthink 
scrolling: scrolling 
frameborder: frameborder 
style: style 
height: height 
capture: capture captures 
may: may 
mar: mar 
feb: feb 
apr: apr 
success: success 
fail: fail 
save: save 
snapshot: snapshot 
open: open 
href: href 
title: title 
share: share 
via: via 
screenshot: screenshot 
collected: collected 
organization: organization 
alexa: alexa 
crawl: crawls crawl 
starting: starting 
internet: internet 
donating: donating 
data: data 
flowing: flowing 
every: every 
day: day 
added: added 
wayback: wayback 
machine: machine 
embargo: embargo 
period: period 
collection: collection 
timestamps: timestamps 
bt: bt 
false: false 
think: think 
like: like 
pythonista: pythonista 
part: part 
thread: thread 
comp: comp 
lang: lang 
kept: kept 
post: post 
link: link links 
seems: seems 
appropriate: appropriate 
dealt: dealt 
question: question 
come: come comes 
relatively: relatively 
often: often 
want: want 
read: read 
google: google 
instead: instead 
answer: answer answers 
alex: alex 
satisfied: satisfied 
customer: customer 
recent: recent 
past: past 
written: written 
april: april 
reference: reference references 
searcher: searcher 
enlightenment: enlightenment 
posted: posted 
following: following 
query: query 
hello: hello 
one: ones one 
thing: thing 
much: much 
statement: statement statements 
work: work works 
would: would 
expect: expect 
take: take 
example: example 
use: use 
dict: dict 
value: values value 
dictionary: dictionaries dictionary 
store: store 
result: result 
change: changes change 
ward: wards 
previously: previously 
stored: stored 
remains: remains 
untouched: untouched 
b: b 
list: list lists 
however: however 
entry: entries 
get: gets get 
counterintuitive: counterintuitive 
behavior: behavior 
recently: recently 
broke: broke 
code: code 
created: created 
automagically: automagically 
updated: updated 
nice: nice 
feature: feature 
nothing: nothing 
expected: expected 
append: append 
look: look looks 
first: first 
case: case cases 
copy: copy copies 
returned: returned 
latter: latter 
ok: ok 
according: according 
philosophy: philosophy 
mind: mind 
anything: anything 
else: else 
depends: depends 
knowledge: knowledge 
type: types type 
put: put 
find: find 
somehow: somehow 
wrong: wrong 
intuition: intuition 
train: train 
thinking: thinking 
execution: execution 
model: model 
better: better 
almost: almost 
needle: needless 
say: say says 
poster: poster posters 
fault: fault 
far: far 
unique: unique 
sort: sort 
misconception: misconceptions misconception 
luckily: luckily 
two: two 
pythonically: pythonically 
experienced: experienced 
martelli: martelli 
particularly: particularly 
pedagogical: pedagogical 
mood: mood 
wrote: wrote 
lengthy: lengthy 
article: articles 
explaining: explaining 
rather: rather 
different: different 
way: way ways 
going: going 
ranted: ranted 
term: terms 
name: names name 
object: object objects 
binding: bindings 
something: something 
enough: enough 
drew: drew 
ascii: ascii 
art: art 
diagram: diagrams 
cover: covers 
interactive: interactive 
session: sessions 
op: op 
confused: confused 
well: well 
clear: clear 
wink: wink 
end: ends end 
email: email 
moment: moment 
wasting: wasting 
time: time 
hand: hand 
drawing: drawings drawing 
terminology: terminology 
actually: actually 
anti: anti 
word: word 
variable: variables variable 
uphelpful: uphelpful 
context: context 
prefer: prefer 
foo: foo 
live: live 
namespaces: namespaces 
really: really 
matter: matter matters 
namespace: namespace 
play: play 
associated: associated 
eval: eval 
print: print 
loop: loop 
interpreter: interpreter 
fact: fact 
minor: minor 
player: players 
current: current 
drama: drama 
real: real 
star: stars 
left: left 
attached: attached 
place: places 
attribute: attributes 
right: right 
always: always 
bar: bar 
meant: meant 
string: string 
drawn: drawn 
differently: differently 
hope: hope 
seem: seem 
draw: draw 
picture: pictures picture 
course: course 
surprise: surprises surprise 
also: also 
chase: chase 
arrow: arrows 
surprising: surprising 
either: either 
realised: realised 
sure: sure 
prose: prose 
help: help 
cheer: cheers 
anyone: anyone 
know: know 
starship: starship 
gone: gone 
mentioning: mentioning 
unboundlocalerror: unboundlocalerror 
point: points point 
shot: shot 
martin: martin 
luther: luther 
nail: nails 
thesis: theses 
church: church 
door: door 
promptly: promptly 
moderated: moderated 
flamebait: flamebait 
cid: cid 
although: although 
seen: seen 
access: access 
long: long 
posting: posting 
became: became 
normal: normal 
might: might 
redraw: redraw 
dia: dia 
someday: someday 
probably: probably 
go: goes 
took: took 
wordier: wordier 
strategy: strategy 
recounting: recounting 
anecdote: anecdote 
statue: statue 
bologna: bologna 
suggesting: suggesting 
borges: borges 
calvino: calvino 
wittgenstein: wittgenstein 
korzibsky: korzibsky 
method: method 
defined: defined 
return: return returns 
new: new 
le: less 
inevitable: inevitable 
since: since 
normally: normally 
must: must 
build: build 
fly: fly 
ask: ask 
except: except 
situation: situation situations 
specifically: specifically 
happen: happen 
vague: vague 
sense: sense 
mentioned: mentioned 
existing: existing 
general: general 
whenever: whenever 
possible: possible 
already: already 
around: around 
copying: copying 
see: see 
module: module 
building: building 
counteintuitive: counteintuitive 
alternative: alternative 
without: without 
imposing: imposing 
huge: huge 
overhead: overhead 
making: making 
everything: everything 
explicit: explicit 
request: request 
could: could 
copied: copied 
referred: referred 
slice: slices slice 
standard: standard 
sequence: sequences 
give: give gives 
immutable: immutable 
care: care 
able: able 
asked: asked 
generality: generality 
thelist: thelist 
limit: limit 
justly: justly 
popular: popular 
numeric: numeric 
package: package 
defines: defines 
array: arrays array 
among: among 
several: several 
sliced: sliced 
import: import 
range: range 
distinct: distinct 
excellent: excellent 
pragmatic: pragmatics 
behind: behind 
simpler: simpler 
worry: worry 
sharing: sharing 
hard: hard 
unsurprising: unsurprising 
somewhat: somewhat 
similar: similar 
differ: differ 
detail: details 
e: e 
g: g 
slicing: slicing 
whatever: whatever 
exception: exception 
later: later 
shallow: shallow 
never: never 
embark: embark 
task: task 
deep: deep 
unless: unless 
function: function 
deepcopy: deepcopy 
serious: serious 
watch: watch 
cycle: cycles 
reproduce: reproduce 
identity: identity 
potentially: potentially 
follow: follow 
depth: depth 
recursively: recursively 
faithfully: faithfully 
graph: graph 
referencing: referencing 
unbounded: unbounded 
complexity: complexity 
fast: fast 
mundane: mundane 
business: business 
turn: turn 
handing: handing 
action: action 
feasible: feasible 
apparently: apparently 
snagged: snagged 
refers: refers 
changing: changing 
se: se 
remain: remain 
mutate: mutate 
mutated: mutated 
using: using 
built: built 
burned: burned 
str: str 
tuple: tuple 
file: file 
int: int 
float: float 
unicode: unicode 
identifier: identifier identifiers 
purpose: purposes 
tempting: tempting 
though: though 
attractive: attractive 
nuisance: nuisance 
habit: habit 
avoiding: avoiding 
trying: trying 
x: x 
ciao: ciao 
puzzling: puzzling 
error: errors 
rebound: rebound 
refer: refer 
certain: certain 
alist: alist 
somedict: somedict 
myfile: myfile 
problem: problem 
simple: simple 
advice: advice 
still: still 
contains: contains 
exactly: exactly 
key: keys 
mutating: mutating 
quite: quite 
another: another 
issue: issue issues 
said: said 
whatsoever: whatsoever 
adict: adict 
pop: pop 
wanted: wanted 
content: content contents 
representation: representation 
isolated: isolated 
delegate: delegates 
job: job 
isolate: isolate 
need: need 
maybe: maybe 
shudder: shudder 
nope: nope 
suitably: suitably 
per: per 
spec: specs 
dependence: dependence 
difference: difference 
year: years 
ago: ago 
local: locals local 
hero: hero 
depicted: depicted 
pointing: pointing 
forward: forwards 
finger: finger 
presumably: presumably 
future: future 
given: given 
placed: placed 
soon: soon 
identified: identified 
hotel: hotel 
belfiore: belfiore 
enterprising: enterprising 
developer: developer 
bought: bought 
restructured: restructured 
particular: particular 
used: used 
restaurant: restaurant 
da: da 
carlo: carlo 
suddenly: suddenly 
become: become 
amazing: amazing 
considering: considering 
marble: marble 
fluid: fluid 
moved: moved 
disturbed: disturbed 
involved: involved 
changed: changed 
even: even 
beyond: beyond 
recognition: recognition 
people: people 
therefore: therefore 
referring: referring 
non: non 
intrinsic: intrinsic 
persistent: persistent 
happenstance: happenstance 
characteristic: characteristic 
led: led 
astray: astray 
trained: trained 
j: j 
l: l 
fiction: fiction 
reasonably: reasonably 
sophisticated: sophisticated 
pleasant: pleasant 
good: good 
bet: bets 
engineer: engineers 
fighting: fighting 
dispell: dispell 
philosopher: philosophers 
kidding: kidding 
realize: realize 
many: many 
pythonistas: pythonistas 
genre: genre 
group: group 
essay: essay essays 
gvr: gvr 
f: f 
source: sources 
prove: prove 
interesting: interesting 
reading: reading 
talk: talks 
terser: terser 
went: went 
away: away 
dear: dear 
michael: michael 
teacher: teachers 
helped: helped 
getting: getting 
thanks: thanks 
lot: lot 
made: made 
obvious: obvious 
ever: ever 
forget: forget 
anymore: anymore 
today: today 
learnt: learnt 
becoming: becoming 
pythoniac: pythoniac 
found: found 
useful: useful 
lucky: lucky 
catch: catch 
writes: writes 
please: please 
send: send 
comment: comments 
praise: praise 
abuse: abuse 
etc: etc 
translate: translate 
document: document 
mean: means 
feel: feel 
free: free 
sent: sent 
translation: translation 
hernan: hernan 
martinez: martinez 
foffani: foffani 
spanish: spanish 
archived: archived 
retrieved: retrieved 
javascript: javascript 
appended: appended 
copyright: copyright 
protected: protected 
u: u 
section: section 
playback: playback 
timing: timings 
m: ms 
exclusion: exclusion 
robot: robots 
policy: policy 
rediscdxsource: rediscdxsource 
esindex: esindex 
loadshardblock: loadshardblock 
petaboxloader: petaboxloader 
datanode: datanode 
cdxlines: cdxlines 
iter: iter 
resolve: resolve 
load: load 
resource: resource 
