gnu: gnu 
manifesto: manifestos manifesto 
wikipedia: wikipedia 
free: free 
encyclopedia: encyclopedia 
jump: jump 
navigation: navigation 
search: search 
call: calls call 
action: action 
create: create 
computer: computers computer 
operating: operating 
system: system 
logo: logo 
richard: richard 
stallman: stallman 
cover: cover 
picture: picture 
reilly: reilly 
medium: media 
book: book 
freedom: freedom 
encouraging: encouraging 
participation: participation 
support: support 
project: project 
goal: goals goal 
developing: developing 
published: published 
march: march 
dr: dr 
dobb: dobb 
journal: journal 
software: software 
tool: tools 
held: held 
high: high 
regard: regard 
within: within 
movement: movement 
fundamental: fundamental 
philosophical: philosophical 
source: source 
full: full 
text: text 
included: included 
emacs: emacs 
publicly: publicly 
available: available 
background: background 
edit: edit 
part: parts part 
began: began 
announcement: announcement 
posted: posted 
september: september 
form: form 
email: email 
usenet: usenet 
newsgroups: newsgroups 
aim: aim 
give: give 
user: users 
control: control 
collaboratively: collaboratively 
providing: providing 
based: based 
idea: idea 
although: although 
written: written 
definition: definition 
existed: existed 
february: february 
way: way ways 
familiarize: familiarize 
people: people 
concept: concepts 
find: find 
work: work works 
money: money 
program: programs 
hardware: hardware 
possessed: possessed 
name: name 
updated: updated 
minor: minor 
summary: summary 
open: opens open 
explanation: explanation 
current: current 
time: time 
progress: progress 
creation: creation 
compatible: compatible 
unix: unix 
meant: meant 
author: author 
many: many 
improvement: improvements 
listed: listed 
detail: detail 
one: one 
major: major 
driving: driving 
point: points 
behind: behind 
according: according 
rapid: rapid 
trend: trend 
toward: toward 
various: various 
component: components 
becoming: becoming 
proprietary: proprietary 
e: e 
closed: closed 
non: non 
libre: libre 
lay: lays 
basis: basis 
launching: launching 
importance: importance 
bringing: bringing 
fruition: fruition 
divide: divide 
longer: longer 
able: able 
help: help 
refuse: refuses 
write: write 
sign: sign 
solidarity: solidarity 
provides: provides 
reason: reasons 
beneficial: beneficial 
agrees: agrees 
wide: wide 
adoption: adoption 
make: make 
programmer: programmer 
le: less 
profitable: profitable 
large: large 
focused: focused 
rebutting: rebutting 
possible: possible 
objection: objections 
include: include 
need: need 
living: living 
issue: issue 
advertising: advertising 
distributing: distributing 
perceived: perceived 
profit: profit 
incentive: incentive 
see: see 
also: also 
mw: mw 
parser: parser 
output: output 
portalbox: portalbox 
float: float 
right: right 
border: border 
solid: solid 
aaa: aaa 
px: px 
padding: padding 
tleft: tleft 
margin: margin 
em: em 
tright: tright 
ul: ul 
display: display 
table: table 
box: box 
sizing: sizing 
max: max 
width: width 
f: f 
font: font 
size: size 
line: line 
height: height 
style: styles style 
italic: italic 
weight: weight 
bold: bold 
li: li 
row: row 
span: span 
first: first 
child: child 
cell: cell 
vertical: vertical 
align: align 
middle: middle 
center: center 
last: last 
portal: portal 
history: history 
letter: letter 
hobbyist: hobbyists 
reference: references 
reflist: reflist 
bottom: bottom 
list: list 
type: type 
decimal: decimal 
inherit: inherit 
column: columns column 
top: top 
ol: ol 
page: page 
break: break 
inside: inside 
avoid: avoid 
upper: upper 
alpha: alpha 
roman: roman 
lower: lower 
greek: greek 
cite: cite 
citation: citation 
word: word 
wrap: wrap 
q: q 
quote: quotes 
target: target 
color: color 
rgba: rgba 
id: id 
lock: lock 
c: cs c 
linear: linear 
gradient: gradient 
transparent: transparent 
url: url 
upload: upload 
wikimedia: wikimedia 
org: org 
common: commons 
green: green 
svg: svg 
repeat: repeat 
limited: limited 
registration: registration 
gray: gray 
alt: alt 
subscription: subscription 
aa: aa 
red: red 
w: ws 
icon: icon 
wikisource: wikisource 
code: code 
none: none 
hidden: hidden 
error: errors error 
visible: visible 
maint: maint 
left: left 
format: format 
kern: kern 
selflink: selflink 
retrieved: retrieved 
requires: requires 
bustillos: bustillos 
maria: maria 
turn: turns 
thirty: thirty 
new: new 
yorker: yorker 
issn: issn 
x: x 
trisquel: trisquel 
linux: linux 
fly: flies 
flag: flag 
computerworld: computerworld 
lwn: lwn 
interview: interview 
net: net 
developer: developer 
do: dos 
long: long 
dead: dead 
live: live 
freedos: freedos 
cnn: cnn 
apple: apple 
warms: warms 
community: community 
june: june 
www: www 
com: com 
hat: hat 
genesis: genesis 
mainstreaming: mainstreaming 
revelation: revelations 
insider: insider 
computerweekly: computerweekly 
b: b 
initial: initial 
bulletin: bulletin 
volume: volume 
number: number 
p: p 
armstrong: armstrong 
alex: alex 
year: years 
ago: ago 
external: external 
link: links 
navbox: navbox 
clear: clear 
auto: auto 
inner: inner 
subgroup: subgroup 
group: group 
title: title 
abovebelow: abovebelow 
white: white 
space: space 
nowrap: nowrap 
fdfdfd: fdfdfd 
tr: tr 
image: image 
ccf: ccf 
ddf: ddf 
ff: ff 
even: even 
odd: odd 
hlist: hlist 
td: td 
dl: dl 
navbar: navbar 
block: block 
inline: inline 
normal: normal 
collapse: collapse 
boxtext: boxtext 
spacing: spacing 
bracket: brackets 
content: content 
abbr: abbr 
decoration: decoration 
mini: mini 
variant: variants variant 
small: small 
cap: caps 
cursor: cursor 
ct: ct 
v: v 
foundation: foundation 
europe: europe 
india: india 
latin: latin 
america: america 
license: license licenses 
general: general 
public: public 
linking: linking 
exception: exception 
lesser: lesser 
affero: affero 
documentation: documentation 
hurd: hurd 
glibc: glibc 
bash: bash 
coreutils: coreutils 
findutils: findutils 
build: build 
gcc: gcc 
binutils: binutils 
gdb: gdb 
grub: grub 
gnustep: gnustep 
gimp: gimp 
jami: jami 
texmacs: texmacs 
octave: octave 
taler: taler 
r: r 
gsl: gsl 
gmp: gmp 
electric: electric 
archimedes: archimedes 
gnunet: gnunet 
privacy: privacy 
guard: guard 
gnuzilla: gnuzilla 
icecat: icecat 
health: health 
gnumed: gnumed 
lilypond: lilypond 
go: go 
chess: chess 
gnash: gnash 
guix: guix 
contributor: contributors 
alexandre: alexandre 
oliva: oliva 
benjamin: benjamin 
mako: mako 
hill: hill 
bradley: bradley 
kuhn: kuhn 
brian: brian 
fox: fox 
federico: federico 
heinz: heinz 
fr: fr 
ric: ric 
couchet: couchet 
georg: georg 
greve: greve 
john: john 
sullivan: sullivan 
jos: jos 
marchesi: marchesi 
joshua: joshua 
gay: gay 
kefah: kefah 
issa: issa 
lo: lo 
dachary: dachary 
nagarjuna: nagarjuna 
g: g 
peter: peter 
heath: heath 
topic: topics 
naming: naming 
controversy: controversy 
revolution: revolution 
o: os 
anti: anti 
window: windows 
campaign: campaigns 
defective: defective 
design: design 
newpp: newpp 
limit: limit 
report: report 
parsed: parsed 
cached: cached 
cache: cache 
expiry: expiry 
reduced: reduced 
false: false 
complication: complications 
vary: vary 
revision: revision 
sha: sha 
cpu: cpu 
usage: usage 
second: seconds 
real: real 
preprocessor: preprocessor 
visited: visited 
node: node 
count: count 
post: post 
expand: expand 
byte: bytes 
template: template 
argument: argument 
highest: highest 
expansion: expansion 
depth: depth 
expensive: expensive 
function: function 
unstrip: unstrip 
recursion: recursion 
lua: lua 
memory: memory 
wikibase: wikibase 
entity: entities 
loaded: loaded 
transclusion: transclusion 
m: ms 
total: total 
short: short 
description: description 
pagetype: pagetype 
web: web 
news: news 
saved: saved 
key: key 
enwiki: enwiki 
pcache: pcache 
idhash: idhash 
canonical: canonical 
timestamp: timestamp 
serialized: serialized 
json: json 
oldid: oldid 
category: categories 
culture: culture 
document: documents 
copyleft: copyleft 
internet: internet 
political: political 
intellectual: intellectual 
property: property 
law: law 
missing: missing 
periodical: periodical 
article: articles 
different: different 
wikidata: wikidata 
menu: menu 
