paris: paris 
jackson: jackson jacksons 
mother: mother 
age: age 
music: music 
biography: biography 
skip: skip 
main: main 
content: content 
people: people 
nostalgia: nostalgia 
celebrity: celebrity 
history: history 
culture: culture 
crime: crime 
scandal: scandal 
video: video 
contact: contact 
u: us 
advertise: advertise 
privacy: privacy 
notice: notice 
term: terms 
use: use 
copyright: copyright 
policy: policy 
ad: ad 
choice: choices 
accessibility: accessibility 
support: support 
setting: settings 
february: february 
subscribe: subscribe 
newsletter: newsletter 
photo: photo 
frazer: frazer 
harrison: harrison 
getty: getty 
image: images 
quick: quick 
fact: facts fact 
name: name 
birth: birth 
date: date 
april: april 
place: place 
beverly: beverly 
hill: hills 
california: california 
full: full 
michael: michael 
katherine: katherine 
zodiac: zodiac 
sign: sign 
aries: aries 
cite: cite 
page: page 
publish: publish 
jun: jun 
comment: comment 
second: second 
child: children child 
daughter: daughter 
pop: pop 
legend: legend 
late: late 
biological: biological 
debbie: debbie 
rowe: rowe 
ex: ex 
wife: wife 
signed: signed 
custody: custody 
well: well 
son: son 
brother: brother brothers 
prince: prince 
following: following 
couple: couple 
divorce: divorce 
youngest: youngest 
sibling: sibling 
blanket: blanket 
bigi: bigi 
father: father 
death: death 
june: june 
suffered: suffered 
cardiac: cardiac 
arrest: arrest 
los: los 
angeles: angeles 
home: home 
died: died 
shortly: shortly 
transported: transported 
nearby: nearby 
hospital: hospital 
time: time 
year: years year 
old: old 
dictated: dictated 
came: came 
legal: legal 
care: care 
grandmother: grandmother 
official: official 
coroner: coroner 
report: report 
released: released 
revealing: revealing 
singer: singer 
acute: acute 
propofol: propofol 
intoxication: intoxication 
aided: aided 
personal: personal 
physician: physician 
dr: dr 
conrad: conrad 
murray: murray 
used: used 
drug: drug 
among: among 
others: others 
help: help 
sleep: sleep 
police: police 
investigation: investigation 
revealed: revealed 
later: later 
licensed: licensed 
prescribe: prescribe 
controlled: controlled 
medication: medications 
doctor: doctor 
action: actions action 
caretaker: caretaker 
subsequently: subsequently 
scrutinized: scrutinized 
found: found 
guilty: guilty 
homicide: homicide 
november: november 
receiving: receiving 
four: four 
prison: prison 
sentence: sentence 
believing: believing 
e: e 
g: g 
live: live 
entertainment: entertainment 
company: company 
promoted: promoted 
planned: planned 
comeback: comeback 
concert: concerts 
failed: failed 
effectively: effectively 
protect: protect 
family: family 
decided: decided 
take: take 
officially: officially 
filed: filed 
wrongful: wrongful 
lawsuit: lawsuit 
trial: trial 
began: began 
lawyer: lawyer lawyers 
sought: sought 
billion: billion 
estimation: estimation 
could: could 
earned: earned 
month: months 
since: since 
alive: alive 
case: case 
october: october 
jury: jury 
determined: determined 
responsible: responsible 
although: although 
terrible: terrible 
tragedy: tragedy 
making: making 
said: said 
marvin: marvin 
putnam: putnam 
public: public 
appearance: appearances appearance 
xa: xa 
managed: managed 
largely: largely 
stay: stay 
limelight: limelight 
infrequently: infrequently 
however: however 
spoke: spoke 
fan: fans 
funeral: funeral 
january: january 
accepting: accepting 
posthumous: posthumous 
lifetime: lifetime 
achievement: achievement 
award: award awards 
grammy: grammy 
made: made 
guest: guest 
oprah: oprah 
winfrey: winfrey 
series: series 
next: next 
chapter: chapter 
discussed: discussed 
childhood: childhood 
experience: experience 
victim: victim 
cyberbullying: cyberbullying 
life: life lives 
trouble: troubles 
early: early 
several: several 
medium: media 
outlet: outlets 
reported: reported 
emergency: emergency 
responder: responders 
called: called 
possible: possible 
suicide: suicide 
attempt: attempt attempts 
according: according 
com: com 
hospitalized: hospitalized 
cut: cut 
wrist: wrists 
kitchen: kitchen 
knife: knife 
took: took 
many: many 
ibuprofen: ibuprofen 
tablet: tablets 
underwent: underwent 
treatment: treatment 
incident: incident 
previous: previous 
one: one 
able: able 
move: move 
forward: forward 
read: read 
bella: bella 
hadid: hadid 
sadie: sadie 
alexander: alexander 
adrienne: adrienne 
kennedy: kennedy 
self: self 
hatred: hatred 
told: told 
rolling: rolling 
stone: stone 
low: low 
esteem: esteem 
thinking: thinking 
anything: anything 
right: right 
worthy: worthy 
living: living 
anymore: anymore 
appeared: appeared 
much: much 
better: better 
dating: dating 
chester: chester 
castellaw: castellaw 
pair: pair 
quits: quits 
turned: turned 
moved: moved 
estate: estate 
converting: converting 
private: private 
studio: studio 
apartment: apartment 
meanwhile: meanwhile 
struck: struck 
relationship: relationship 
musician: musician 
snoddy: snoddy 
ended: ended 
july: july 
court: court 
granted: granted 
temporary: temporary 
restraining: restraining 
order: order 
man: man 
claimed: claimed 
stalking: stalking 
document: documents 
accused: accused 
stalker: stalker 
approached: approached 
outside: outside 
recording: recording 
waited: waited 
extensively: extensively 
refused: refused 
leave: leave 
also: also 
mentioned: mentioned 
shotgun: shotgun 
saying: saying 
midnight: midnight 
two: two 
instagram: instagram 
story: story stories 
undergone: undergone 
surgery: surgery 
remove: remove 
abscess: abscess 
almost: almost 
size: size 
golf: golf 
ball: ball 
despite: despite 
pain: pain 
perform: perform 
band: band 
soundflowers: soundflowers 
day: day 
acting: acting 
modeling: modeling 
career: career 
known: known 
piercing: piercing 
ice: ice 
blue: blue 
eye: eyes 
beauty: beauty 
come: come 
young: young 
adult: adult 
appearing: appearing 
red: red 
carpet: carpet 
event: events 
trying: trying 
hand: hand 
img: img 
model: models 
got: got 
first: first 
job: job 
fox: fox 
star: star 
produced: produced 
directed: directed 
lee: lee 
daniel: daniels 
film: film 
gringo: gringo 
length: length 
album: albums album 
wilted: wilted 
lead: lead 
single: single 
x: x 
c: c 
let: let 
received: received 
critical: critical 
applause: applause 
usa: usa 
today: today 
spin: spin 
weekly: weekly 
check: check 
strive: strive 
accuracy: accuracy 
fairness: fairness 
see: see 
something: something 
look: look 
citation: citation 
information: information 
article: article 
title: title 
author: author 
editor: editors 
website: website 
url: url 
access: access 
publisher: publisher 
television: television 
network: networks 
last: last 
updated: updated 
original: original 
published: published 
receive: receive 
shaped: shaped 
world: world 
person: person 
best: best 
international: international 
superstar: superstar 
rest: rest 
famous: famous 
multi: multi 
talented: talented 
musical: musical 
entertainer: entertainer 
enjoyed: enjoyed 
chart: chart 
topping: topping 
solo: solo 
artist: artists artist 
selling: selling 
thriller: thriller 
number: number 
hit: hits hit 
bad: bad 
wall: wall 
ii: ii 
third: third 
joseph: joseph 
jr: jr 
nicknamed: nicknamed 
jermaine: jermaine 
member: member 
group: group 
tj: tj 
performing: performing 
guardianship: guardianship 
cousin: cousins 
janet: janet 
contemporary: contemporary 
roster: roster 
includes: includes 
control: control 
rhythm: rhythm 
nation: nation 
velvet: velvet 
rope: rope 
unbreakable: unbreakable 
randy: randy 
fame: fame 
r: r 
b: b 
loading: loading 
logo: logo 
registered: registered 
trademark: trademarks 
llc: llc 
close: close 
