group: groups group 
biography: biographies biography 
skip: skip 
main: main 
content: content 
people: people 
nostalgia: nostalgia 
celebrity: celebrity 
history: history 
culture: culture 
crime: crime 
scandal: scandal 
video: video videos 
contact: contact 
u: us u 
advertise: advertise 
privacy: privacy 
notice: notice 
term: terms 
use: use 
copyright: copyright 
policy: policy 
ad: ad 
choice: choices 
accessibility: accessibility 
support: support 
setting: settings 
february: february 
subscribe: subscribe 
newsletter: newsletter 
famous: famous 
jazz: jazz 
musician: musicians 
like: like 
louis: louis 
armstrong: armstrong 
duke: duke 
ellington: ellington 
mile: miles 
davis: davis 
billie: billie 
holiday: holiday 
ella: ella 
fitzgerald: fitzgerald 
nina: nina 
simone: simone 
made: made 
major: major 
global: global 
phenomenon: phenomenon 
black: black 
scientist: scientists 
george: george 
washington: washington 
carver: carver 
neil: neil 
degrasse: degrasse 
tyson: tyson 
otis: otis 
boykin: boykin 
mae: mae 
c: c 
jemison: jemison 
great: great 
contribution: contributions 
scientific: scientific 
progress: progress 
abolitionist: abolitionists 
sojourner: sojourner 
truth: truth 
harriet: harriet 
beecher: beecher 
stowe: stowe 
frederick: frederick 
douglas: douglass 
william: william 
lloyd: lloyd 
garrison: garrison 
raised: raised 
voice: voices 
protest: protest 
slavery: slavery 
britain: britain 
shakespeare: shakespeare 
j: j 
k: k 
rowling: rowling 
queen: queen 
elizabeth: elizabeth 
ii: ii 
kate: kate 
middleton: middleton 
princess: princess 
diana: diana 
among: among 
british: british 
native: native 
american: americans american 
leader: leaders 
geronimo: geronimo 
sitting: sitting 
bull: bull 
pocahontas: pocahontas 
crazy: crazy 
horse: horse 
chief: chief 
joseph: joseph 
sacagawea: sacagawea 
fought: fought 
recognition: recognition 
right: rights 
immigrant: immigrants 
albert: albert 
einstein: einstein 
nikola: nikola 
tesla: tesla 
arnold: arnold 
schwarzenegger: schwarzenegger 
embody: embody 
dream: dream 
civil: civil 
war: war 
figure: figures 
abraham: abraham 
lincoln: lincoln 
jefferson: jefferson 
robert: robert 
e: e 
lee: lee 
ulysses: ulysses 
grant: grant 
stonewall: stonewall 
jackson: jackson 
tecumseh: tecumseh 
sherman: sherman 
played: played 
prominent: prominent 
role: roles 
activist: activists 
known: known 
fight: fight 
social: social 
injustice: injustice 
lasting: lasting 
impact: impact 
life: lives 
oppressed: oppressed 
include: include 
martin: martin 
luther: luther 
king: king 
jr: jr 
tubman: tubman 
rosa: rosa 
park: parks 
w: w 
b: b 
du: du 
bois: bois 
malcolm: malcolm 
x: x 
revolution: revolution 
abigail: abigail 
adam: adams 
benjamin: benjamin 
franklin: franklin 
alexander: alexander 
hamilton: hamilton 
thomas: thomas 
others: others 
rose: rose 
prominence: prominence 
basketball: basketball 
player: players 
stephen: stephen 
curry: curry 
lebron: lebron 
james: james 
michael: michael 
jordan: jordan 
kareem: kareem 
abdul: abdul 
jabbar: jabbar 
kobe: kobe 
bryant: bryant 
excel: excel 
fast: fast 
paced: paced 
demanding: demanding 
professional: professional 
sport: sports sport 
woman: women 
susan: susan 
anthony: anthony 
cady: cady 
stanton: stanton 
gloria: gloria 
steinem: steinem 
malala: malala 
yousafzai: yousafzai 
full: full 
equality: equality 
month: month 
march: march 
celebrates: celebrates 
throughout: throughout 
science: science 
politics: politics 
law: law 
art: arts 
entertainment: entertainment 
many: many 
field: fields 
explore: explore 
article: articles 
celebrate: celebrate 
historic: historic 
achievement: achievement 
infamous: infamous 
mobster: mobsters 
al: al 
capone: capone 
bugsy: bugsy 
siegel: siegel 
lucky: lucky 
luciano: luciano 
teflon: teflon 
john: john 
gotti: gotti 
notorious: notorious 
coast: coast 
founding: founding 
father: fathers 
america: america 
included: included 
madison: madison 
monroe: monroe 
beat: beat 
writer: writers 
generation: generation 
allen: allen 
ginsberg: ginsberg 
jack: jack 
kerouac: kerouac 
ken: ken 
kesey: kesey 
amiri: amiri 
baraka: baraka 
burroughs: burroughs 
left: left 
highly: highly 
influential: influential 
mark: marks 
literature: literature 
spanish: spanish 
explorer: explorers 
juan: juan 
ponce: ponce 
de: de 
le: le 
n: n 
lvar: lvar 
ez: ez 
cabeza: cabeza 
vaca: vaca 
francisco: francisco 
pizarro: pizarro 
hern: hern 
cort: cort 
hernando: hernando 
soto: soto 
royal: royal 
family: family 
includes: includes 
victoria: victoria 
prince: prince 
harry: harry 
meghan: meghan 
markle: markle 
female: female 
talk: talk 
show: show 
host: hosts 
oprah: oprah 
winfrey: winfrey 
tyra: tyra 
bank: banks 
joan: joan 
river: rivers 
rosie: rosie 
donnell: donnell 
ellen: ellen 
degeneres: degeneres 
barbara: barbara 
walter: walters 
sally: sally 
jessy: jessy 
raphael: raphael 
kelly: kelly 
ripa: ripa 
artist: artists 
jean: jean 
michel: michel 
basquiat: basquiat 
augusta: augusta 
savage: savage 
kara: kara 
walker: walker 
jacob: jacob 
lawrence: lawrence 
gordon: gordon 
african: african 
perspective: perspective 
world: world 
toni: toni 
morrison: morrison 
langston: langston 
hughes: hughes 
richard: richard 
wright: wright 
zora: zora 
neale: neale 
hurston: hurston 
alex: alex 
haley: haley 
maya: maya 
angelou: angelou 
baldwin: baldwin 
created: created 
literary: literary 
work: works 
hispanic: hispanic 
athlete: athletes 
roberto: roberto 
clemente: clemente 
rodriguez: rodriguez 
lionel: lionel 
messi: messi 
sammy: sammy 
sosa: sosa 
oscar: oscar 
la: la 
hoya: hoya 
become: become 
household: household 
name: names 
singer: singers 
latino: latino 
selena: selena 
jennifer: jennifer 
lopez: lopez 
estefan: estefan 
marc: marc 
carlos: carlos 
santana: santana 
conquered: conquered 
music: music 
breaking: breaking 
barrier: barriers 
genre: genres 
inventor: inventors 
madam: madam 
lonnie: lonnie 
g: g 
johnson: johnson 
garrett: garrett 
morgan: morgan 
patricia: patricia 
bath: bath 
revered: revered 
genius: geniuses 
cult: cult 
charles: charles 
manson: manson 
david: david 
koresh: koresh 
jim: jim 
jones: jones 
bhagwan: bhagwan 
shree: shree 
rajneesh: rajneesh 
gained: gained 
international: international 
notoriety: notoriety 
exposing: exposing 
dark: dark 
side: side 
humanity: humanity 
loading: loading 
see: see 
logo: logo 
registered: registered 
trademark: trademarks 
television: television 
network: networks 
llc: llc 
close: close 
