minitab: minitab 
wikipedia: wikipedia 
free: free 
encyclopedia: encyclopedia 
jump: jump 
navigation: navigation 
search: search 
statistic: statistics 
software: software 
article: articles article 
includes: includes 
list: list 
general: general 
reference: references 
remains: remains 
largely: largely 
unverified: unverified 
lack: lacks 
sufficient: sufficient 
corresponding: corresponding 
inline: inline 
citation: citations citation 
please: please 
help: help helps 
improve: improve 
introducing: introducing 
precise: precise 
march: march 
learn: learn 
remove: remove 
template: template 
message: message 
mw: mw 
parser: parser 
output: output 
infobox: infobox 
subbox: subbox 
padding: padding 
border: border 
none: none 
margin: margin 
px: px 
width: width 
auto: auto 
min: min 
font: font 
size: size 
clear: clear 
float: float 
background: background 
color: color 
transparent: transparent 
col: cols 
child: child 
navbar: navbar 
body: body 
skin: skin 
minerva: minerva 
header: header 
subheader: subheader 
title: title 
image: image 
full: full 
data: data 
text: text 
align: align 
center: center 
running: running 
window: windows 
original: original 
author: author 
barbara: barbara 
f: f 
ryan: ryan 
thomas: thomas 
jr: jr 
brian: brian 
l: l 
joiner: joiner 
developer: developer 
llc: llc 
initial: initial 
release: release 
stable: stable 
april: april 
month: months 
ago: ago 
operating: operating 
system: system 
web: web 
app: app 
formerly: formerly 
mac: mac 
type: type 
statistical: statistical 
analysis: analysis 
license: license 
trialware: trialware 
website: website 
com: com 
package: package packages 
developed: developed 
pennsylvania: pennsylvania 
state: state 
university: university 
researcher: researchers 
conjunction: conjunction 
triola: triola 
company: company 
began: began 
light: light 
version: version 
omnitab: omnitab 
program: program 
national: national 
institute: institute 
standard: standards 
technology: technology 
content: content contents 
history: history 
interoperability: interoperability 
see: see 
also: also 
reading: reading 
external: external 
link: link links 
edit: edit 
section: section 
need: needs 
expansion: expansion 
adding: adding 
january: january 
project: project 
received: received 
funding: funding 
nist: nist 
conceived: conceived 
joseph: joseph 
hilsenrath: hilsenrath 
year: years 
ibm: ibm 
documentation: documentation 
last: last 
published: published 
significant: significant 
development: development 
since: since 
distributed: distributed 
privately: privately 
owned: owned 
headquartered: headquartered 
college: college 
covid: covid 
pandemic: pandemic 
requested: requested 
million: million 
paycheck: paycheck 
protection: protection 
avoid: avoid 
let: let 
go: go 
employee: employees 
subsidiary: subsidiaries 
uk: uk 
france: france 
germany: germany 
hong: hong 
kong: kong 
australia: australia 
produce: produces 
used: used 
connect: connect 
business: businesses business 
centralize: centralize 
organize: organize 
quality: quality 
trainer: trainer 
elearning: elearning 
teach: teaches 
concept: concepts 
workspace: workspace 
provides: provides 
planning: planning 
visualization: visualization 
tool: tool tools 
engage: engage 
idea: idea 
innovation: innovation 
management: management 
well: well 
managing: managing 
six: six 
sigma: sigma 
lean: lean 
manufacturing: manufacturing 
deployment: deployments 
october: october 
launched: launched 
first: first 
cloud: cloud 
based: based 
june: june 
desktop: desktop 
available: available 
former: former 
macos: macos 
x: x 
longer: longer 
supported: supported 
comparison: comparison 
reflist: reflist 
bottom: bottom 
em: em 
style: styles style 
decimal: decimal 
inherit: inherit 
column: columns column 
top: top 
ol: ol 
li: li 
page: page 
break: break 
inside: inside 
upper: upper 
alpha: alpha 
roman: roman 
lower: lower 
greek: greek 
b: b 
cite: cite 
word: word 
wrap: wrap 
q: q 
quote: quotes 
target: target 
rgba: rgba 
id: id 
lock: lock 
c: cs c 
linear: linear 
gradient: gradient 
url: url 
upload: upload 
wikimedia: wikimedia 
org: org 
common: commons 
green: green 
svg: svg 
right: right 
repeat: repeat 
limited: limited 
registration: registration 
gray: gray 
alt: alt 
subscription: subscription 
aa: aa 
red: red 
w: w ws 
icon: icon 
wikisource: wikisource 
logo: logo 
code: code 
hidden: hidden 
error: error 
display: display 
visible: visible 
maint: maint 
left: left 
format: format 
kern: kern 
selflink: selflink 
weight: weight 
support: support 
policy: policy 
www: www 
retrieved: retrieved 
peavy: peavy 
sally: sally 
nb: nbs 
special: special 
publication: publication 
digital: digital 
computer: computer 
newsletter: newsletter 
gov: gov 
u: us 
havener: havener 
crispin: crispin 
wide: wide 
variety: variety 
local: local 
sought: sought 
federal: federal 
ppp: ppp 
loan: loans 
wjac: wjac 
status: status 
product: products 
launch: launches 
tm: tm 
accelerate: accelerate 
generation: generation 
transformation: transformation 
globalnewswire: globalnewswire 
new: new 
solution: solutions 
organization: organizations 
globenewswire: globenewswire 
feature: features 
process: process 
improvement: improvement 
n: n 
p: p 
apr: apr 
groebner: groebner 
david: david 
mark: mark 
berenson: berenson 
levine: levine 
timothy: timothy 
krehbiel: krehbiel 
hang: hang 
lau: lau 
applied: applied 
custom: custom 
ed: ed 
boston: boston 
pearson: pearson 
publishing: publishing 
prentice: prentice 
hall: hall 
print: print 
akers: akers 
michael: michael 
exploring: exploring 
analysing: analysing 
interpreting: interpreting 
st: st 
united: united 
kingdom: kingdom 
compass: compass 
isbn: isbn 
brook: brook 
quentin: quentin 
complete: complete 
toolbox: toolbox 
guide: guide 
practitioner: practitioners 
rd: rd 
opex: opex 
resource: resources resource 
ltd: ltd 
bryman: bryman 
alan: alan 
cramer: cramer 
duncan: duncan 
quantitative: quantitative 
social: social 
scientist: scientists 
london: london 
routledge: routledge 
hardwick: hardwick 
colin: colin 
practical: practical 
design: design 
experiment: experiments 
doe: doe 
made: made 
easy: easy 
liberation: liberation 
book: books 
khan: khan 
rehman: rehman 
problem: problem 
solving: solving 
using: using 
methodology: methodology 
york: york 
wiley: wiley 
meyer: meyer 
ruth: ruth 
k: k 
krueger: krueger 
saddle: saddle 
river: river 
nj: nj 
stein: stein 
philip: philip 
g: g 
matey: matey 
james: james 
r: r 
pitt: pitts 
karen: karen 
review: review 
apple: apple 
macintosh: macintosh 
american: american 
statistician: statistician 
doi: doi 
robert: roberts 
dennis: dennis 
penn: penn 
official: official 
navbox: navbox 
box: box boxes 
sizing: sizing 
solid: solid 
inner: inner 
subgroup: subgroup 
group: group 
abovebelow: abovebelow 
line: line 
height: height 
white: white 
space: space 
nowrap: nowrap 
fdfdfd: fdfdfd 
tr: tr 
ccf: ccf 
ddf: ddf 
e: e 
ff: ff 
even: even 
odd: odd 
hlist: hlist 
td: td 
dl: dl 
ul: ul 
block: block 
normal: normal 
collapse: collapse 
boxtext: boxtext 
spacing: spacing 
bracket: brackets 
span: span 
abbr: abbr 
decoration: decoration 
mini: mini 
variant: variant 
small: small 
cap: caps 
cursor: cursor 
ct: ct 
v: v 
public: public 
domain: domain 
dataplot: dataplot 
epi: epi 
info: info 
cspro: cspro 
arima: arima 
open: open 
source: source 
admb: admb 
dap: dap 
gretl: gretl 
jasp: jasp 
jag: jags 
jmulti: jmulti 
julia: julia 
jupyter: jupyter 
ju: ju 
lia: lia 
py: py 
thon: thon 
gnu: gnu 
octave: octave 
openbugs: openbugs 
orange: orange 
pspp: pspp 
python: python 
statsmodels: statsmodels 
pymc: pymc 
ipython: ipython 
idle: idle 
rstudio: rstudio 
sagemath: sagemath 
simfit: simfit 
sofa: sofa 
stan: stan 
xlispstat: xlispstat 
freeware: freeware 
bv: bv 
cumfreq: cumfreq 
segreg: segreg 
xplore: xplore 
winbugs: winbugs 
commercial: commercial 
cross: cross 
platform: platform 
desk: desk 
gauss: gauss 
graphpad: graphpad 
instat: instat 
prism: prism 
spss: spss 
modeler: modeler 
jmp: jmp 
maple: maple 
mathcad: mathcad 
mathematica: mathematica 
matlab: matlab 
oxmetrics: oxmetrics 
rat: rats 
revolution: revolution 
analytics: analytics 
sa: sas 
smartpls: smartpls 
stata: stata 
statview: statview 
sudaan: sudaan 
plus: plus 
tsp: tsp 
world: world 
programming: programming 
wps: wps 
bmdp: bmdp 
eviews: eviews 
genstat: genstat 
limdep: limdep 
lisrel: lisrel 
medcalc: medcalc 
microfit: microfit 
mlwin: mlwin 
nc: ncss 
shazam: shazam 
sigmastat: sigmastat 
statistica: statistica 
statsdirect: statsdirect 
statxact: statxact 
systat: systat 
unscrambler: unscrambler 
unistat: unistat 
excel: excel 
add: add 
ons: ons 
analyse: analyse 
xlfit: xlfit 
rexcel: rexcel 
category: categories category 
borough: borough 
metropolitan: metropolitan 
area: area 
harris: harris 
patton: patton 
ferguson: ferguson 
centre: centre 
county: county 
happy: happy 
valley: valley 
dubois: dubois 
csa: csa 
education: education 
park: park 
campus: campus 
school: school 
district: district 
high: high 
schlow: schlow 
region: region 
library: library 
culture: culture 
art: arts 
theatre: theatre 
central: central 
festival: festival 
industry: industry 
accuweather: accuweather 
transportation: transportation 
airport: airport 
authority: authority 
sport: sports 
spike: spikes 
medlar: medlar 
field: field 
lubrano: lubrano 
shopping: shopping 
nittany: nittany 
mall: mall 
colonnade: colonnade 
newspaper: newspapers 
daily: daily 
collegian: collegian 
time: time times 
television: television 
wpsu: wpsu 
tv: tv 
pb: pbs 
create: create 
kid: kids 
nbc: nbc 
metv: metv 
comet: comet 
cw: cw 
wwcp: wwcp 
fox: fox 
abc: abc 
grio: grio 
ant: ant 
wtaj: wtaj 
cbs: cbs 
mystery: mystery 
laff: laff 
grit: grit 
watm: watm 
cozi: cozi 
wkbs: wkbs 
cor: cor 
court: court 
bounce: bounce 
ion: ion 
dabl: dabl 
defy: defy 
truereal: truereal 
newsy: newsy 
faith: faith 
family: family 
radio: radio 
dv: dv 
bb: bb 
bz: bz 
dk: dk 
ez: ez 
waly: waly 
wapy: wapy 
wbhv: wbhv 
fm: fm 
wblf: wblf 
wbus: wbus 
wcob: wcob 
wfge: wfge 
wkpa: wkpa 
wkps: wkps 
wlej: wlej 
wmaj: wmaj 
wowy: wowy 
wphb: wphb 
hd: hd 
wqck: wqck 
wqwk: wqwk 
wrsc: wrsc 
wrxv: wrxv 
wryv: wryv 
wtlr: wtlr 
wwot: wwot 
wxm: wxm 
wzww: wzww 
fire: fire 
mount: mount 
medical: medical 
newpp: newpp 
limit: limit 
report: report 
parsed: parsed 
cached: cached 
cache: cache 
expiry: expiry 
reduced: reduced 
false: false 
complication: complications 
vary: vary 
revision: revision 
sha: sha 
cpu: cpu 
usage: usage 
second: seconds 
real: real 
preprocessor: preprocessor 
visited: visited 
node: node 
count: count 
post: post 
expand: expand 
include: include 
byte: bytes 
argument: argument 
highest: highest 
depth: depth 
expensive: expensive 
function: function 
unstrip: unstrip 
recursion: recursion 
lua: lua 
memory: memory 
number: number 
wikibase: wikibase 
entity: entities 
loaded: loaded 
transclusion: transclusion 
m: ms 
call: calls 
total: total 
short: short 
description: description 
simple: simple 
footnote: footnotes 
saved: saved 
key: key 
enwiki: enwiki 
pcache: pcache 
idhash: idhash 
canonical: canonical 
timestamp: timestamp 
serialized: serialized 
json: json 
oldid: oldid 
match: matches 
wikidata: wikidata 
lacking: lacking 
expanded: expanded 
menu: menu 
