body: body 
margin: margin 
top: top 
important: important 
padding: padding 
min: min 
width: width widths 
px: px 
wm: wm 
rw: rw 
iframe: iframe 
id: ids id 
donato: donato 
src: src 
platform: platforms platform 
wb: wb 
referer: referer 
web: web 
archive: archives archive 
org: org 
doc: docs doc 
python: python 
release: releases release 
whatsnew: whatsnew 
changelog: changelog 
html: html 
scrolling: scrolling 
frameborder: frameborder 
style: styles style 
height: height 
capture: capture captures 
oct: oct 
nov: nov 
dec: dec 
feb: feb 
apr: apr 
success: success 
fail: fail 
save: saves save 
snapshot: snapshot 
open: opens open 
href: href 
title: title 
share: share 
via: via 
screenshot: screenshot 
collected: collected 
collection: collection collections 
gdelt: gdelt 
project: project projects 
timestamps: timestamps 
wayback: wayback 
machine: machine machines 
bt: bt 
false: false 
navigation: navigation 
index: indices index indexes 
module: modules module 
next: next 
previous: previous 
documentation: documentation 
new: new 
inline: inline 
search: search searches 
show: show shows 
final: final 
date: date 
library: library libraries 
bpo: bpo 
fix: fixes fix 
sqlite: sqlite 
segfault: segfault 
backing: backing 
closed: closed 
database: database databases 
patch: patches patch 
contributed: contributed 
peter: peters peter 
david: david 
mccormick: mccormick 
longer: longer 
override: overrides override 
exception: exception exceptions 
raised: raised 
len: len 
sequence: sequence sequences 
parameter: parameter parameters 
programmingerror: programmingerror 
fixed: fixed 
crash: crash crashes 
mutate: mutate 
list: list lists 
iteration: iteration iterations 
default: defaults default 
missing: missing 
duplicate: duplicates duplicate 
valueerror: valueerror 
set: sets set 
context: contexts context 
original: original 
test: test tests 
add: adds add 
sigint: sigint 
handling: handling 
runpy: runpy 
build: builds build 
update: updates update 
py: py 
unreachable: unreachable 
use: use 
builtin: builtin 
compiler: compiler compilers 
able: able 
dong: dong 
hee: hee 
na: na 
candidate: candidate 
core: core cores 
builtins: builtins 
dir: dir 
type: types type 
genericalias: genericalias 
batuhan: batuhan 
taskaya: taskaya 
possible: possible 
stack: stack 
overflow: overflow overflows 
parser: parser parsers 
parsing: parsing 
function: function functions 
class: classes class 
huge: huge 
ammount: ammount 
argument: arguments argument 
pablo: pablo 
galindo: galindo 
wrong: wrong 
error: errors error 
description: description 
using: using 
format: format formats 
string: string strings 
f: f fs 
str: str 
occurred: occurred 
destroying: destroying 
subclass: subclasses subclass 
memoryerror: memoryerror 
ast: ast 
us: uses 
global: global 
state: state states 
per: per 
instance: instances instance 
causing: causing 
subtle: subtle 
practical: practical 
problem: problems problem 
example: examples example 
mercurial: mercurial 
replaces: replaces 
import: imports import 
implement: implements implement 
lazy: lazy 
whereas: whereas 
expected: expected 
always: always 
return: return returns 
fully: fully 
initialized: initialized 
free: free 
allocated: allocated 
va: va 
mkstack: mkstack 
fails: fails 
small: small 
bug: bug bugs 
dropping: dropping 
key: key keys 
compiling: compiling 
dict: dict 
literal: literals literal 
xffff: xffff 
element: element elements 
output: outputs output 
help: help helps 
contains: contains 
ascii: ascii 
character: characters character 
make: makes make 
trace: trace traces 
correct: correct 
calling: calling 
generator: generators generator 
throw: throw throws 
yielded: yielded 
yield: yield 
allowing: allowing 
enums: enums 
extended: extended 
multiple: multiple 
inheritance: inheritance 
mix: mix 
data: data 
constructing: constructing 
honor: honor honors 
object: object objects 
enum: enum 
creation: creation 
specifically: specifically 
repr: repr 
reduce: reduce 
ex: ex 
race: race races 
condition: condition conditions 
call: calls call 
soon: soon 
threadsafe: threadsafe 
method: method methods 
asyncio: asyncio 
proactoreventloop: proactoreventloop 
nothing: nothing 
self: self 
pipe: pipes pipe 
socket: sockets socket 
turtle: turtle 
vec: vec 
rmul: rmul 
int: int 
float: float floats 
debug: debug 
mode: mode modes 
run: run runs 
allows: allows 
setting: settings setting 
pythonasynciodebug: pythonasynciodebug 
x: x 
dev: dev 
enable: enable 
implementation: implementations implementation 
sendfile: sendfile 
compatible: compatible 
solaris: solaris 
restarting: restarting 
window: windows window 
log: logs log 
spurious: spurious 
connectionreseterrors: connectionreseterrors 
pdb: pdb 
whatis: whatis 
command: commands command 
correctly: correctly 
report: report reports 
rather: rather 
cancelling: cancelling 
task: task tasks 
due: due 
timeout: timeout 
wait: wait waits 
cancellation: cancellation 
complete: complete 
also: also 
case: case cases 
like: like 
positive: positives positive 
timeouts: timeouts 
properly: properly 
handle: handles handle 
completion: completions completion 
wrapped: wrapped 
awaitable: awaitable 
change: changes change 
abstracteventloop: abstracteventloop 
executor: executor 
coroutine: coroutine 
codeop: codeop 
regression: regression regressions 
prevented: prevented 
turning: turning 
compile: compile 
warning: warnings warning 
settarget: settarget 
flush: flush 
logging: logging 
handler: handlers handler 
memoryhandler: memoryhandler 
prevent: prevent 
creating: creating 
shared: shared 
memory: memory 
sharedmemory: sharedmemory 
size: sizes size 
issue: issue issues 
preventing: preventing 
c: cs c 
zoneinfo: zoneinfo 
subclassed: subclassed 
ssl: ssl 
wrap: wraps wrap 
raise: raise raises 
ssleoferror: ssleoferror 
oserror: oserror 
peer: peer 
close: close closes 
connection: connections connection 
tl: tls 
negotiation: negotiation 
pathlib: pathlib 
posixpath: posixpath 
resolve: resolve resolves 
relative: relative 
path: path paths 
located: located 
root: roots root 
directory: directory directories 
shipman: shipman 
tkinter: tkinter 
link: link links 
tkdocs: tkdocs 
removed: removed 
nmt: nmt 
server: servers server 
responds: responds 
much: much 
faster: faster 
includes: includes 
short: short 
explanatory: explanatory 
note: note notes 
signature: signature signatures 
typing: typing 
sphinx: sphinx 
allow: allow 
pre: pre 
v: vs v 
option: option options 
disable: disable 
warn: warn 
allowed: allowed 
refactored: refactored 
rst: rst 
arranging: arranging 
decorator: decorators decorator 
sub: sub 
section: section sections 
code: codes code 
recipe: recipe recipes 
licensed: licensed 
permissive: permissive 
bsd: bsd 
license: license 
addition: addition additions 
existing: existing 
cmd: cmd 
line: lines line 
script: scripts script 
pas: pass 
vv: vv 
pycore: pycore 
byteswap: byteswap 
h: h 
header: header headers 
file: files file 
support: support supports 
old: old 
clang: clang 
version: versions version 
bswap: bswap 
available: available 
llvm: llvm 
layout: layouts layout 
page: page pages 
installer: installer 
removing: removing 
special: special 
thanks: thanks 
mark: marks mark 
hammond: hammond 
permission: permission permissions 
api: api 
pyos: pyos 
mystrnicmp: mystrnicmp 
mystricmp: mystricmp 
incremented: incremented 
pointer: pointers pointer 
beyond: beyond 
end: ends end 
interrupt: interrupts interrupt 
come: come comes 
eof: eof 
stdioreadline: stdioreadline 
potential: potential 
unicodedecodeerror: unicodedecodeerror 
dis: dis 
ensurepip: ensurepip 
install: install 
pip: pip 
setuptools: setuptools 
recv: recv 
value: values value 
brokenpipeerror: brokenpipeerror 
empty: empty 
byte: byte bytes 
b: b 
runnable: runnable 
tclerror: tclerror 
instead: instead 
typeerror: typeerror 
unknown: unknown 
passed: passed 
optionmenu: optionmenu 
nameerror: nameerror 
interface: interfaces interface 
done: done 
callback: callbacks callback 
loop: loop loops 
sock: sock 
accept: accept 
unsubscribe: unsubscribe 
reader: readers reader 
early: early 
overhead: overhead 
uuid: uuid 
recursive: recursive 
evaluation: evaluation 
forwardref: forwardref 
get: gets get 
hint: hint hints 
selector: selectors selector 
defaultselector: defaultselector 
based: based 
upon: upon 
lineno: lineno 
none: none 
increment: increment 
feature: feature features 
changed: changed 
future: future futures 
annotation: annotations annotation 
becomes: becomes 
following: following 
pep: peps pep 
appears: appears 
uac: uac 
prompt: prompts prompt 
improve: improve 
post: post 
message: message messages 
direct: direct 
people: people 
ucrt: ucrt 
dependency: dependencies dependency 
downloaded: downloaded 
demand: demand 
include: include 
idle: idles idle 
user: users user 
never: never 
see: see 
loaded: loaded 
ending: endings ending 
blank: blank 
different: different 
system: system systems 
beta: beta 
security: security 
pth: pth 
ignored: ignored 
caused: caused 
cve: cve 
audit: audit 
hook: hooks hook 
cleared: cleared 
later: later 
finalization: finalization 
avoid: avoid 
event: events event 
ensure: ensure 
dll: dll 
location: location locations 
embedded: embedded 
injection: injections injection 
rejecting: rejecting 
control: control 
client: client clients 
putrequest: putrequest 
cpython: cpython 
defining: defining 
setattr: setattr 
multi: multi 
setup: setup 
hierarchy: hierarchy 
chain: chains chain 
could: could 
extension: extensions extension 
involved: involved 
base: bases base 
cache: cache caches 
running: running 
holder: holders holder 
incorrect: incorrect 
refcounting: refcounting 
servername: servername 
non: non 
null: null 
peg: peg 
keyword: keyword 
overcome: overcome 
compiled: compiled 
xlc: xlc 
pycf: pycf 
level: levels level 
await: await 
would: would 
aggressively: aggressively 
comprehension: comprehension comprehensions 
co: co 
making: making 
async: async 
tagged: tagged 
guard: guard 
dereference: dereference 
within: within 
bytearrayobject: bytearrayobject 
triggered: triggered 
bytearray: bytearray 
operation: operation operations 
hackcheck: hackcheck 
prevents: prevents 
sneaking: sneaking 
around: around 
superclass: superclass 
rewritten: rewritten 
implemented: implemented 
heap: heap 
unpickling: unpickling 
invalid: invalid 
newobj: newobj 
opcode: opcode 
unpicklingerror: unpicklingerror 
crashing: crashing 
infinite: infinite 
reading: reading 
specially: specially 
crafted: crafted 
tar: tars tar 
tarfile: tarfile 
sslcontext: sslcontext 
load: load loads 
dh: dh 
params: params 
distutils: distutils 
spawn: spawn 
restore: restore 
expectation: expectation 
distutilsexecerror: distutilsexecerror 
found: found 
remove: remove removes 
generic: generic generics 
email: email 
contentmanager: contentmanager 
content: content contents 
updated: updated 
comprehensively: comprehensively 
elaborate: elaborate 
behaviour: behaviour 
gather: gather 
cancel: cancel cancels 
macos: macos 
char: char chars 
released: released 
keywords: keywords 
name: names name 
rewrite: rewrite 
revert: revert 
pytype: pytype 
hasfeature: hasfeature 
read: read reads 
directly: directly 
pytypeobject: pytypeobject 
tp: tp 
flag: flag flags 
member: members member 
limited: limited 
used: used 
getflags: getflags 
hide: hides hide 
detail: detail details 
hash: hash hashes 
ipaddress: ipaddress 
ipv: ipv 
incorrectly: incorrectly 
generated: generated 
constant: constants constant 
respectively: respectively 
resulted: resulted 
collision: collision collisions 
generate: generate 
tuple: tuple 
address: addresses address 
mask: mask 
length: lengths length 
network: networks network 
decoding: decoding 
utf: utf 
locale: locale locales 
prefix: prefix prefixes 
expression: expressions expression 
syntaxerror: syntaxerror 
feed: feed 
u: us u 
skip: skip skips 
shifting: shifting 
node: node nodes 
completed: completed 
deprecate: deprecate 
pynode: pynode 
reference: reference references 
deallocated: deallocated 
space: space spaces 
startup: startup 
sys: sys 
involving: involving 
symlink: symlink 
supplied: supplied 
discovered: discovered 
coverity: coverity 
asserts: asserts 
hashtable: hashtable 
opt: opt 
serialization: serialization 
deserialization: deserialization 
random: random 
pyparser: pyparser 
simpleparsestringflags: simpleparsestringflags 
simpleparsestringflagsfilename: simpleparsestringflagsfilename 
simpleparsefileflags: simpleparsefileflags 
stefan: stefan 
behnel: behnel 
reported: reported 
cf: cf 
even: even 
intention: intention 
documented: documented 
behavior: behaviors behavior 
text: text 
continuation: continuation 
e: e es 
backslash: backslash 
contain: contain 
last: last 
buffer: buffer buffers 
gathering: gathering 
information: information 
emitting: emitting 
syntax: syntax 
refleak: refleak 
fopen: fopen 
obj: obj 
pysys: pysys 
configuration: configuration configurations 
take: takes take 
pyconfig: pyconfig 
platlibdir: platlibdir 
account: accounts account 
considered: considered 
tokenizer: tokenizer 
single: single 
newline: newline 
token: tokens token 
emitted: emitted 
working: working 
threw: threw 
valid: valid 
input: input inputs 
interpreted: interpreted 
unexpected: unexpected 
iter: iter 
masked: masked 
operator: operators operator 
indexof: indexof 
countof: countof 
private: private 
macro: macro macros 
comp: comp 
diag: diag 
push: push 
ignore: ignore 
depr: depr 
decls: decls 
pop: pop pops 
write: write 
history: history 
atexit: atexit 
readline: readline 
completer: completer 
ignores: ignores 
filesystem: filesystem 
ignoring: ignoring 
filenotfounderror: filenotfounderror 
permissionerror: permissionerror 
decimal: decimals decimal 
requires: requires 
libmpdec: libmpdec 
cli: cli 
source: source sources 
encoding: encoding encodings 
several: several 
select: select 
anthony: anthony 
sottile: sottile 
zip: zip 
writing: writing 
find: finds find 
determines: determines 
keylog: keylog 
might: might 
mimetypes: mimetypes 
mime: mime 
rule: rule rules 
srinivas: srinivas 
reddy: reddy 
thatiparthy: thatiparthy 
glob: glob 
stdlib: stdlib 
part: parts part 
escaped: escaped 
disables: disables 
installing: installing 
bundled: bundled 
krzysztof: krzysztof 
konopko: konopko 
current: current 
r: r 
mi: mi mis 
lapeyre: lapeyre 
minor: minor 
leak: leak leaks 
subprocess: subprocess 
extra: extras extra 
group: groups group 
specified: specified 
standard: standard standards 
deviation: deviation 
variance: variance 
statistic: statistics 
mu: mu 
xbar: xbar 
loader: loaders loader 
implementing: implementing 
supplying: supplying 
traversableresources: traversableresources 
generating: generating 
truncate: truncate 
sending: sending 
xxsubinterpreters: xxsubinterpreters 
channel: channels channel 
send: send 
csv: csv 
writer: writer 
writerow: writerow 
writerows: writerows 
restored: restored 
deprecated: deprecated 
xml: xml 
etree: etree 
celementtree: celementtree 
cgi: cgi 
parse: parse 
multipart: multipart 
without: without 
roger: roger 
duran: duran 
integer: integer integers 
array: arrays array 
bit: bit bits 
larger: larger 
testfn: testfn 
regrtest: regrtest 
linux: linuxes linux 
multiprocessing: multiprocessing 
cannot: cannot 
create: create 
shm: shm 
broken: broken 
synchronize: synchronize 
require: require 
mac: mac macs 
freebsd: freebsd 
copyreg: copyreg 
numpy: numpy 
installed: installed 
pickletester: pickletester 
restores: restores 
filter: filters filter 
importing: importing 
remote: remote 
imaplib: imaplib 
host: host hosts 
cyrus: cyrus 
andrew: andrew 
cmu: cmu 
edu: edu 
blocking: blocking 
incoming: incoming 
binhex: binhex 
twice: twice 
fresh: fresh 
deprecationwarning: deprecationwarning 
time: time times 
gdb: gdb 
hp: hp 
ux: ux 
michael: michael 
osipov: osipov 
pin: pin 
makefile: makefile 
msilib: msilib 
opendatabase: opendatabase 
init: init 
sql: sql 
openview: openview 
openssl: openssl 
g: g 
extend: extend 
exe: exe 
mention: mention mentions 
venv: venv 
shebang: shebang 
environmental: environmental 
variable: variables variable 
ini: ini 
opening: opening 
finder: finder finders 
rick: rick 
heil: heil 
configure: configure 
building: building 
shortly: shortly 
first: first 
developer: developers developer 
preview: preview 
big: big 
sur: sur 
known: known 
supported: supported 
bugfix: bugfix 
xdg: xdg 
browser: browsers browser 
webbrowser: webbrowser 
stdin: stdin 
stdout: stdout 
stderr: stderr 
o: os 
unicode: unicode 
copy: copy copies 
fill: fill 
pyunicode: pyunicode 
wstr: wstr 
fromunicode: fromunicode 
asunicode: asunicode 
asunicodeandsize: asunicodeandsize 
match: matches match 
since: since 
pyerrors: pyerrors 
defines: defines 
snprintf: snprintf 
vsnprintf: vsnprintf 
fromspec: fromspec 
overwrite: overwrite 
attribute: attribute attributes 
getset: getset 
importlib: importlib 
resource: resources resource 
reverted: reverted 
built: built 
sourcefileloader: sourcefileloader 
zipimporter: zipimporter 
incompatible: incompatible 
introduced: introduced 
certificate: certificate certificates 
destination: destination 
lib: lib 
dynload: dynload 
containing: containing 
statement: statement statements 
producing: producing 
assignment: assignment assignments 
form: forms form 
p: ps p 
checking: checking 
newlines: newlines 
validating: validating 
custom: custom 
true: true 
overriding: overriding 
pythonplatlibdir: pythonplatlibdir 
environment: environments environment 
gil: gil 
usage: usage 
lock: locks lock 
thread: thread threads 
pending: pending 
signal: signal signals 
corner: corner 
formatting: formatting 
failed: failed 
trailing: trailing 
zero: zeroes zeros zero 
fstring: fstring 
filename: filenames filename 
resides: resides 
created: created 
fromspecwithbases: fromspecwithbases 
automatically: automatically 
visit: visit 
traversing: traversing 
garbage: garbage 
collector: collector 
manually: manually 
hang: hang hangs 
arise: arise 
cycle: cycle cycles 
refresh: refresh 
metadata: metadata 
stop: stops stop 
maybe: maybe 
interactiveinterpreter: interactiveinterpreter 
three: three 
supply: supply supplies 
resourcereader: resourcereader 
fallback: fallback 
topological: topological 
sort: sort sorts 
functionality: functionality 
initially: initially 
functools: functools 
moved: moved 
graphlib: graphlib 
better: better 
accommodate: accommodate 
tool: tool tools 
keep: keeps keep 
scope: scope scopes 
initialize: initialize 
pydatetime: pydatetime 
isocalendardatetype: isocalendardatetype 
pure: pure 
wayland: wayland 
display: display displays 
j: j 
attali: attali 
hashlib: hashlib 
compare: compare compares 
digest: digest digests 
crypto: crypto 
memcmp: memcmp 
ctypes: ctypes 
convert: convert converts 
result: results result 
unraisablehook: unraisablehook 
called: called 
previously: previously 
logged: logged 
pyerr: pyerr 
print: prints print 
symbol: symbol symbols 
initialization: initializations initialization 
upload: upload 
creates: creates 
sha: sha 
blake: blake 
md: md 
skipped: skipped 
block: block blocks 
fall: falls fall 
back: back 
provides: provides 
algorithm: algorithm algorithms 
blocked: blocked 
policy: policy policies 
func: func 
usedforsecurity: usedforsecurity 
evp: evp 
constructor: constructor constructors 
smtplib: smtplib 
strict: strict 
documenting: documenting 
le: le less 
prepare: prepare 
pymodule: pymodule 
addtype: addtype 
added: added 
mainly: mainly 
io: io 
bound: bounds bound 
separate: separate 
essentially: essentially 
work: work works 
high: high 
tracemalloc: tracemalloc 
reset: resets reset 
peak: peak 
traced: traced 
measure: measure 
specific: specific specifics 
piece: pieces 
argumenterror: argumenterror 
invoked: invoked 
purepath: purepath 
reflect: reflect 
start: starts start 
collapsing: collapsing 
whitespace: whitespace 
encoded: encoded 
word: words word 
bare: bare 
quote: quotes quote 
struct: struct 
raising: raising 
conflicting: conflicting 
experimental: experimental 
isolated: isolated 
subinterpreters: subinterpreters 
experiment: experiment 
continues: continues 
master: master 
branch: branch branches 
needed: needed 
included: included 
registered: registered 
plain: plain 
define: define 
reparse: reparse 
tag: tags tag 
appexeclink: appexeclink 
sdk: sdk 
menu: menu menus 
cut: cut cuts 
right: right 
clicking: clicking 
selection: selection selections 
export: export exports 
explicitly: explicitly 
getargcargv: getargcargv 
document: documents document 
exported: exported 
implicitly: implicitly 
fvisibility: fvisibility 
hidden: hidden 
slot: slot slots 
spec: spec specs 
interruptoccurred: interruptoccurred 
fatal: fatal 
libuuid: libuuid 
rpcrt: rpcrt 
runtime: runtime 
parenthesis: parenthesis parentheses 
omitted: omitted 
required: required 
isidentifier: isidentifier 
canonicalized: canonicalized 
bmp: bmp 
improved: improved 
swallowed: swallowed 
apply: apply 
abc: abcs abc 
n: ns n 
col: col cols 
offset: offset offsets 
joannah: joannah 
nanjekye: nanjekye 
port: port ports 
errno: errno 
multiphase: multiphase 
throughs: throughs 
reversed: reversed 
weakref: weakref 
proxy: proxy proxies 
syslog: syslog 
reporting: reporting 
specialised: specialised 
backwards: backwards 
compatibility: compatibility 
concern: concerns 
immediately: immediately 
follow: follow 
reserved: reserved 
construct: constructs construct 
bg: bg 
clear: clear clears 
else: else 
fca: fca 
failing: failing 
acceptable: acceptable 
breakage: breakage 
notice: notice 
imp: imp 
deprecation: deprecations deprecation 
pyimport: pyimport 
reloadmodule: reloadmodule 
robert: roberts robert 
rouhani: rouhani 
nested: nested 
stat: stat 
implicit: implicit 
chaining: chaining 
mapping: mapping mappings 
cjkcodecs: cjkcodecs 
frame: frames frame 
robust: robust 
w: w wss 
bytecode: bytecode 
ability: ability 
interpreter: interpreters interpreter 
associated: associated 
internal: internal 
performance: performance performances 
pylong: pylong 
fromdouble: fromdouble 
fit: fit 
long: long 
segment: segment segments 
incomplete: incomplete 
irit: irit 
katriel: katriel 
bisect: bisect 
clinic: clinic 
timezones: timezones 
paul: paul 
ganssle: ganssle 
hmac: hmac 
expose: exposes expose 
con: cons con 
inner: inner 
outer: outer 
public: public 
disabled: disabled 
selectively: selectively 
enabled: enabled 
shake: shake 
xof: xof 
compiles: compiles 
alpha: alpha 
inspect: inspect 
getdoc: getdoc 
propagate: propagate 
happens: happens 
roman: roman 
skurikhin: skurikhin 
edge: edge 
caret: caret 
printed: printed 
pointing: pointing 
max: max 
sure: sure 
simpler: simpler 
discoverable: discoverable 
way: way ways 
access: access accesses 
unbounded: unbounded 
variant: variants variant 
lru: lru 
maxsize: maxsize 
iana: iana 
zone: zone 
args: args 
alias: aliases alias 
subscripted: subscripted 
posixmodule: posixmodule 
posix: posix 
nt: nt 
msg: msg 
optional: optional 
count: count counts 
sample: samples sample 
actively: actively 
check: checks check 
made: made 
mandatory: mandatory 
safely: safely 
cancelled: cancelled 
traceback: traceback 
interrupted: interrupted 
target: target targets 
weakrefs: weakrefs 
fnmatch: fnmatch 
exponential: exponential 
presence: presence 
pattern: pattern patterns 
repaired: repaired 
regular: regular 
futile: futile 
backtracking: backtracking 
compileall: compileall 
hardlinks: hardlinks 
pyc: pyc 
optimization: optimization optimizations 
eval: eval 
malformed: malformed 
silently: silently 
conforming: conforming 
curtis: curtis 
bucher: bucher 
shuffle: shuffle 
win: win 
ver: ver 
produce: produces produce 
ptype: ptype 
pickle: pickle pickles 
positional: positional 
nntplib: nntplib 
merge: merge 
nntp: nntp 
nntpbase: nntpbase 
dbm: dbm 
gnu: gnu 
gdbm: gdbm 
subinterpreter: subinterpreter 
child: children child 
process: process processes 
fork: fork 
randbytes: randbytes 
ease: ease 
subclassing: subclassing 
reuses: reuses 
getrandbits: getrandbits 
difflib: difflib 
sequencematcher: sequencematcher 
longest: longest 
concurrent: concurrent 
threadwakeup: threadwakeup 
protected: protected 
shutdown: shutdown 
queue: queue 
simplequeue: simplequeue 
unittest: unittest 
mock: mocks mock 
magicmock: magicmock 
magic: magic 
subdirectory: subdirectories subdirectory 
package: package packages 
matching: matching 
backport: backport 
imap: imap 
unselect: unselect 
union: union 
two: two 
one: ones one 
nonetype: nonetype 
mappingproxytype: mappingproxytype 
reversible: reversible 
simplenamespace: simplenamespace 
insertion: insertion 
ordered: ordered 
alphabetical: alphabetical 
aix: aix 
cputime: cputime 
nanosecond: nanosecond 
resolution: resolutions resolution 
clock: clock clocks 
gettime: gettime 
m: ms 
defined: defined 
ethan: ethan 
onstott: onstott 
argparse: argparse 
namespace: namespace 
displayed: displayed 
order: order 
formerly: formerly 
though: though 
preserved: preserved 
visible: visible 
isocalendar: isocalendar 
datetime: datetime 
named: named 
removal: removal 
explicit: explicit 
passing: passing 
coros: coros 
provide: provide 
docstrings: docstrings 
awaitables: awaitables 
tutorial: tutorial 
sorted: sorted 
technique: techniques 
given: given 
explanation: explanation 
explain: explain 
basic: basic 
leave: leave 
unchanged: unchanged 
docutils: docutils 
pkg: pkg 
pythoninfo: pythoninfo 
exit: exits exit 
move: moves move 
dirnamew: dirnamew 
isolate: isolate 
winsock: winsock 
pytime: pytime 
timeval: timeval 
increase: increase increases 
datagram: datagram 
endpoint: endpoint endpoints 
family: family families 
coming: coming 
tcl: tcl 
tk: tk 
framework: framework frameworks 
older: older 
configured: configured 
universalsdk: universalsdk 
isysroot: isysroot 
searched: searched 
still: still 
overridden: overridden 
tcltk: tcltk 
libs: libs 
rfc: rfc 
demo: demos demo 
multissltest: multissltest 
helper: helper helpers 
latest: latest 
typo: typos typo 
turtledemo: turtledemo 
download: download 
url: urls url 
try: tries try 
clearstaticstrings: clearstaticstrings 
pycfunction: pycfunction 
checkexact: checkexact 
exact: exact 
subtypes: subtypes 
well: well 
pycmethod: pycmethod 
subtype: subtype 
declare: declare 
gettopmostexception: gettopmostexception 
pyapi: pyapi 
remains: remains 
nullify: nullify 
inittab: inittab 
situation: situation situations 
gregory: gregory 
szorc: szorc 
pythreadstate: pythreadstate 
getframe: getframe 
strong: strong 
pygc: pygc 
collect: collect 
pyasyncgen: pyasyncgen 
clearfreelists: clearfreelists 
pycontext: pycontext 
clearfreelist: clearfreelist 
pydict: pydict 
pyfloat: pyfloat 
pyframe: pyframe 
pylist: pylist 
pyset: pyset 
pytuple: pytuple 
getback: getback 
getcode: getcode 
borrowed: borrowed 
provided: provided 
traverse: traverse 
accessible: accessible 
marcel: marcel 
plch: plch 
petr: petr 
viktorin: viktorin 
disallow: disallow 
cr: cr 
lf: lf 
headerregistry: headerregistry 
attack: attacks attack 
abstractbasicauthhandler: abstractbasicauthhandler 
urllib: urllib 
request: requests request 
inefficient: inefficient 
exploited: exploited 
attacker: attacker 
cause: causes cause 
denial: denial 
service: services service 
regex: regex 
catastrophic: catastrophic 
vulnerability: vulnerability vulnerabilities 
ben: ben 
caller: caller 
matt: matt 
schwager: schwager 
hex: hex 
switch: switch 
temporarily: temporarily 
oldparser: oldparser 
pythonoldparser: pythonoldparser 
completely: completely 
including: including 
already: already 
anything: anything 
depends: depends 
follows: follows 
unparse: unparse 
postponed: postponed 
activated: activated 
specialized: specialized 
encounter: encounter encounters 
main: main 
trying: trying 
encode: encode 
decode: decode 
development: development 
codecs: codecs 
machinery: machinery 
late: late 
refleaks: refleaks 
json: json 
memo: memo 
pyscannerobject: pyscannerobject 
traversed: traversed 
speed: speed speeds 
vectorcall: vectorcall 
convention: convention conventions 
column: columns column 
math: math 
star: star 
furkan: furkan 
onder: onder 
paulo: paulo 
henrique: henrique 
silva: silva 
must: must 
tstate: tstate 
subsequent: subsequent 
parsetok: parsetok 
realloc: realloc 
misuse: misuse 
rare: rare 
codepath: codepath 
removeprefix: removeprefix 
removesuffix: removesuffix 
corresponding: corresponding 
userstring: userstring 
affix: affixes 
present: present 
full: full 
dennis: dennis 
sweeney: sweeney 
etc: etc 
unparsing: unparsing 
infinity: infinity 
number: number numbers 
ta: ta 
kaya: kaya 
shannon: shannon 
origin: origin 
optimize: optimize 
closefrom: closefrom 
fd: fd 
syscall: syscall 
cheap: cheap 
sysconf: sysconf 
sc: sc 
descriptor: descriptor descriptors 
millisecond: milliseconds 
workaround: workaround 
mount: mount 
fdescfs: fdescfs 
kernel: kernel kernels 
initial: initial 
ed: ed 
maste: maste 
emaste: emaste 
conrad: conrad 
meyer: meyer 
cem: cem 
kyle: kyle 
evans: evans 
kevans: kevans 
kubilay: kubilay 
kocak: kocak 
koobs: koobs 
closerange: closerange 
low: low 
greater: greater 
equal: equal 
waitpid: waitpid 
status: status 
unsigned: unsigned 
typevar: typevar 
weipeng: weipeng 
hong: hong 
imported: imported 
lazily: lazily 
assertlogs: assertlogs 
assertion: assertion assertions 
isolatedasynciotestcase: isolatedasynciotestcase 
shareablelist: shareablelist 
setitem: setitem 
item: item items 
stem: stem 
replaced: replaced 
shown: shown 
correspondent: correspondent 
concrete: concrete 
docstring: docstring 
inherited: inherited 
parent: parent parents 
pydoc: pydoc 
spooledtemporaryfile: spooledtemporaryfile 
seek: seek 
position: position positions 
zscore: zscore 
normaldist: normaldist 
succeed: succeed 
namedtuple: namedtuple 
human: human 
readable: readable 
field: field fields 
accessors: accessors 
kqueueselector: kqueueselector 
fds: fds 
modulefinder: modulefinder 
respect: respects respect 
coding: coding 
comment: comments comment 
daemon: daemon 
denied: denied 
worker: worker workers 
processpoolexecutor: processpoolexecutor 
spawned: spawned 
reuse: reuse 
optimizes: optimizes 
reduces: reduces 
amount: amount amounts 
lost: lost 
cpu: cpus cpu 
stanley: stanley 
reinit: reinit 
reinitialize: reinitialize 
symtable: symtable 
symboltable: symboltable 
exec: exec 
local: locals local 
realmem: realmem 
reverting: reverting 
patcher: patcher 
enter: enter 
returning: returning 
silence: silences silence 
equesthandler: equesthandler 
killed: killed 
triying: triying 
incorrently: incorrently 
waitstatus: waitstatus 
exitcode: exitcode 
threading: threading 
mainthread: mainthread 
dummythread: dummythread 
rlock: rlock 
unlocked: unlocked 
rename: rename 
raw: raw 
join: join 
par: parses 
www: www 
authenticate: authenticate 
accepts: accepts 
challenge: challenge challenges 
realm: realm 
adding: adding 
register: register 
prior: prior 
joining: joining 
bootstrap: bootstrap 
external: external externals 
winreg: winreg 
redundant: redundant 
getgrouplist: getgrouplist 
retry: retry 
failure: failure failures 
glibc: glibc 
ngroups: ngroups 
total: total 
double: double 
tai: tai 
operating: operating 
clarify: clarify 
relationship: relationship 
table: table tables 
weakvaluedictionary: weakvaluedictionary 
weakkeydictionary: weakkeydictionary 
linear: linear 
getitem: getitem 
avoids: avoids 
quadratic: quadratic 
iterating: iterating 
thomas: thomas 
krennwallner: krennwallner 
undocumented: undocumented 
closing: closing 
manager: managers manager 
remain: remain 
op: op 
immutable: immutable 
chainmap: chainmap 
normalization: normalization 
elementtree: elementtree 
entity: entity entities 
asyncgen: asyncgen 
recognizes: recognizes 
walrus: walrus 
delay: delay 
invocation: invocation 
uname: uname 
processor: processor processors 
requested: requested 
getsource: getsource 
returned: returned 
karthikeyan: karthikeyan 
singaravelan: singaravelan 
shlex: shlex 
split: split 
zackery: zackery 
spytz: spytz 
uninitialized: uninitialized 
xmlparser: xmlparser 
oren: oren 
milman: milman 
claimed: claimed 
model: model 
preservation: preservation 
samy: samy 
lahfa: lahfa 
strvar: strvar 
dom: dom 
minidom: minidom 
coercion: coercion 
vxworks: vxworks 
rtos: rtos 
travis: travis 
ci: ci 
azure: azure 
pipeline: pipelines 
moreover: moreover 
emit: emit 
verbose: verbose 
ftplib: ftplib 
ftp: ftp 
latin: latin 
domain: domain domains 
testing: testing 
msgid: msgid 
doctest: doctest 
testfile: testfile 
loading: loading 
whose: whose 
donis: donis 
msbuild: msbuild 
property: properties property 
nuget: nuget 
native: native 
prop: props 
ordering: ordering 
sometimes: sometimes 
grep: grep 
arnon: arnon 
yaari: yaari 
registry: registry registries 
installers: installers 
installs: installs 
easier: easier 
embed: embed 
application: applications application 
pixel: pixel pixels 
icon: icon icons 
modern: modern 
clover: clover 
delete: delete 
unused: unused 
icns: icns 
freeze: freeze 
fetching: fetching 
calltip: calltip 
checkpyc: checkpyc 
please: please 
force: forces force 
alternative: alternative 
translation: translation 
elif: elif 
head: head 
structure: structures structure 
pyobject: pyobject 
gc: gc 
istracked: istracked 
isfinalized: isfinalized 
query: query queries 
currently: currently 
tracked: tracked 
finalized: finalized 
var: vars var 
newvar: newvar 
basicsize: basicsize 
accessed: accessed 
listptr: listptr 
weaklistoffset: weaklistoffset 
checkbuffer: checkbuffer 
pyindex: pyindex 
opaque: opaque 
getid: getid 
unique: unique 
identifier: identifier identifiers 
hostnames: hostnames 
addressing: addressing 
potentially: potentially 
malicious: malicious 
invalidurl: invalidurl 
multithreaded: multithreaded 
schedule: schedules schedule 
addpendingcall: addpendingcall 
instruction: instructions instruction 
executed: executed 
execute: execute 
executes: executes 
handled: handled 
scheduled: scheduled 
heapq: heapq 
itertools: itertools 
frozenset: frozenset 
pyruntimestate: pyruntimestate 
ceval: ceval 
tracing: tracing 
pyinterpreterstate: pyinterpreterstate 
replace: replace 
inside: inside 
repl: repl 
executing: executing 
asynchronous: asynchronous 
chaged: chaged 
overallocation: overallocation 
strategy: strategy 
overallocates: overallocates 
closer: closer 
overalocated: overalocated 
earlier: earlier 
destructors: destructors 
unclosed: unclosed 
reliable: reliable 
symlinks: symlinks 
point: points point 
wozniski: wozniski 
pyeval: pyeval 
restorethread: restorethread 
pyruntime: pyruntime 
interp: interp 
dangling: dangling 
finalize: finalize 
systemerror: systemerror 
atan: atan 
copysign: copysign 
remainder: remainder 
converted: converted 
pygilstate: pygilstate 
affect: affect affects 
consumer: consumers 
contextvar: contextvar 
caching: caching 
cached: cached 
heavy: heavy 
observed: observed 
scenario: scenarios 
weak: weak 
ordereddict: ordereddict 
audioop: audioop 
relax: relax 
grammar: grammars grammar 
restriction: restrictions restriction 
tweak: tweaks tweak 
deadlock: deadlocks deadlock 
detection: detection 
asutf: asutf 
andsize: andsize 
slightly: slightly 
need: need needs 
ext: ext 
slice: slices slice 
foo: foo 
notimplemented: notimplemented 
boolean: boolean 
josh: josh 
rosenberg: rosenberg 
pyvenv: pyvenv 
launcher: launcher 
session: sessions session 
zipfile: zipfile 
validation: validation 
dummy: dummy 
getnode: getnode 
augload: augload 
augstore: augstore 
bin: bin 
virtual: virtual 
param: param 
finalizing: finalizing 
pool: pools pool 
experienced: experienced 
terminate: terminate 
settrace: settrace 
setprofile: setprofile 
lsprof: lsprof 
profiler: profiler 
scratch: scratch 
bootsubprocess: bootsubprocess 
depending: depending 
cursor: cursor 
truncated: truncated 
colnames: colnames 
asyncmock: asyncmock 
awaited: awaited 
environ: environ 
environb: environb 
invokes: invokes 
hence: hence 
tightly: tightly 
coupled: coupled 
newer: newer 
internally: internally 
distributor: distributors 
seed: seeds seed 
bool: bool 
scandir: scandir 
emits: emits 
resourcewarning: resourcewarning 
abstract: abstract 
arbitrary: arbitrary 
listener: listener 
preferred: preferred 
temporary: temporary 
large: large 
af: af 
unix: unix 
dump: dumps dump 
kind: kind kinds 
tuples: tuples 
catch: catches catch 
runtimeerror: runtimeerror 
dictionary: dictionaries dictionary 
getmodule: getmodule 
tried: tried 
kept: kept 
transition: transition 
getconnection: getconnection 
andler: andler 
reimplement: reimplement 
enables: enables 
defaultdict: defaultdict 
pathlike: pathlike 
refactor: refactor 
maintain: maintain 
attributeerror: attributeerror 
pyasyncgenobject: pyasyncgenobject 
ddir: ddir 
pathname: pathname 
submodules: submodules 
beneath: beneath 
tree: trees tree 
pythoncaseok: pythoncaseok 
tempfile: tempfile 
softspace: softspace 
shantanu: shantanu 
degradation: degradation 
zipp: zipp 
asdl: asdl 
suite: suite suites 
abstractdigestauthhandler: abstractdigestauthhandler 
qop: qop 
tatu: tatus 
teapot: teapot 
http: http 
ross: ross 
rhodes: rhodes 
attrs: attrs 
treebuilder: treebuilder 
consistency: consistency 
indicated: indicated 
desire: desire 
parity: parity 
except: except 
assure: assure 
stream: streams stream 
starred: starred 
vlad: vlad 
emelianov: emelianov 
standalone: standalone 
declaration: declarations declaration 
compliance: compliance 
extensible: extensible 
markup: markup 
language: language languages 
fifth: fifth 
edition: edition 
recommendation: recommendation 
scoped: scoped 
oleksandr: oleksandr 
pavliuk: pavliuk 
simplified: simplified 
subscription: subscription 
simple: simple 
represented: represented 
extslice: extslice 
meantime: meantime 
specification: specifications specification 
restricts: restricts 
namespaces: namespaces 
dicts: dicts 
misleading: misleading 
mixed: mixed 
numeric: numeric 
comparison: comparisons comparison 
operand: operand 
argc: argc 
detects: detects 
binary: binaries binary 
optimized: optimized 
site: sites site 
shutil: shutil 
chown: chown 
uid: uid 
gid: gid 
resolved: resolved 
exist: exist 
nobody: nobody 
dtrace: dtrace 
additional: additional 
dflags: dflags 
stored: stored 
fedora: fedora 
suse: suse 
jan: jan 
mat: mat 
jek: jek 
cepl: cepl 
charalampos: charalampos 
stratakis: stratakis 
victor: victor 
stinner: stinner 
ensures: ensures 
vcruntime: vcruntime 
computer: computer 
hibernated: hibernated 
whilst: whilst 
waiting: waiting 
mutex: mutex 
related: related 
day: days day 
uptime: uptime 
statically: statically 
redistributable: redistributable 
unavailable: unavailable 
distributed: distributed 
continue: continue 
visual: visual 
studio: studio 
msvc: msvc 
repository: repository 
image: images image 
go: go 
box: box boxes 
edit: edit 
accidental: accidental 
deletion: deletion 
ln: ln 
bar: bar 
selecting: selecting 
jump: jump jumps 
acquire: acquire 
pthread: pthread 
cond: cond 
timedwait: timedwait 
getproxies: getproxies 
jos: jos 
roberto: roberto 
meza: meza 
cabrera: cabrera 
exposed: exposed 
pythreadframegetter: pythreadframegetter 
pyarg: pyarg 
nokwnames: nokwnames 
getinterpreter: getinterpreter 
unraisable: unraisable 
static: statics static 
flavor: flavor 
enterrecursivecall: enterrecursivecall 
leaverecursivecall: leaverecursivecall 
trashcan: trashcan 
begin: begins begin 
pytrash: pytrash 
pydescr: pydescr 
newmethod: newmethod 
newex: newex 
bad: bad 
initthreads: initthreads 
threadsinitialized: threadsinitialized 
analog: analogs 
pynumber: pynumber 
tobase: tobase 
fatalerror: fatalerror 
unless: unless 
pymoduledef: pymoduledef 
yet: yet 
mod: mod 
precisely: precisely 
getstate: getstate 
affected: affected 
buildvalue: buildvalue 
undefined: undefined 
ssize: ssize 
clean: cleans clean 
whwn: whwn 
getevalframefunc: getevalframefunc 
setevalframefunc: setevalframefunc 
pyframeevalfunction: pyframeevalfunction 
fcntl: fcntl 
msvcrt: msvcrt 
unsafe: unsafe 
execution: execution 
pty: pty 
issubclass: issubclass 
yonatan: yonatan 
goldschmidt: goldschmidt 
chroot: chroot 
whether: whether 
aclose: aclose 
exhausted: exhausted 
constructed: constructed 
dotted: dotted 
crypt: crypt 
contextvars: contextvars 
readinto: readinto 
bufferedreader: bufferedreader 
localtime: localtime 
year: year years 
felt: felt 
pickler: pickler 
deleted: deleted 
pickled: pickled 
comparing: comparing 
floor: floor 
division: division 
zerodivisionerror: zerodivisionerror 
bz: bz 
complex: complex 
bytecodes: bytecodes 
map: maps map 
unpack: unpack 
drop: drop 
bruce: bruce 
merry: merry 
carlier: carlier 
range: range ranges 
userdict: userdict 
brandt: brandt 
idiom: idiom 
expr: expr 
fast: fast 
indexerror: indexerror 
punycode: punycode 
codec: codec 
obsolete: obsolete 
bdb: bdb 
entry: entry entries 
expanded: expanded 
gcd: gcd 
lcm: lcm 
unsupportedoperation: unsupportedoperation 
least: least 
common: common 
hanging: hanging 
processpoolexcutor: processpoolexcutor 
pickling: pickling 
typeddict: typeddict 
totality: totality 
starting: starting 
sysconfig: sysconfig 
uncommon: uncommon 
installation: installations installation 
usr: usr 
deque: deque 
hold: holds 
fixing: fixing 
bdist: bdist 
msi: msi 
wheel: wheels wheel 
published: published 
fraction: fraction fractions 
numerator: numerator 
denominator: denominator 
normalize: normalize 
depended: depended 
walk: walk 
fwalk: fwalk 
rglob: rglob 
getters: getters 
iglob: iglob 
argumentparser: argumentparser 
abbrev: abbrev 
striped: striped 
shortdescription: shortdescription 
pkgutil: pkgutil 
reached: reached 
binascii: binascii 
crc: crc 
hqx: hqx 
annotated: annotated 
till: till 
varoquaux: varoquaux 
konstantin: konstantin 
kashin: kashin 
autospec: autospec 
complain: complain 
vegard: vegard 
stikbakke: stikbakke 
pyinit: pyinit 
omit: omit 
devmajor: devmajor 
devminor: devminor 
device: device devices 
enabling: enabling 
started: started 
shutting: shutting 
semaphore: semaphores semaphore 
calculate: calculate 
boundarguments: boundarguments 
ordereddicts: ordereddicts 
propagation: propagation 
lazycache: lazycache 
refactoring: refactoring 
getline: getline 
checkcache: checkcache 
specifies: specifies 
adapted: adapted 
furman: furman 
typedict: typedict 
pyclbr: pyclbr 
appropriate: appropriate 
readmodule: readmodule 
hakan: hakan 
elik: elik 
semantics: semantics 
pymapping: pymapping 
setitemstring: setitemstring 
filling: filling 
overlap: overlap 
region: region regions 
may: may 
left: left lefts 
unfilled: unfilled 
mmap: mmap 
fact: fact 
give: give gives 
impression: impression 
programmer: programmer 
subsection: subsection 
toc: toc 
pdf: pdf 
winconsoleio: winconsoleio 
overflowerror: overflowerror 
allocs: allocs 
sxs: sxs 
manifest: manifest manifests 
virtualenv: virtualenv 
active: active 
attempting: attempting 
unresolved: unresolved 
home: home 
expanduser: expanduser 
prefer: prefer 
userprofile: userprofile 
normally: normally 
behave: behave 
bat: bat 
quiet: quiet 
q: qs q 
pyparse: pyparse 
good: good 
font: font fonts 
duplicated: duplicated 
remaining: remaining 
configdialog: configdialog 
button: buttons button 
highlight: highlights highlight 
tab: tabs tab 
shell: shell shells 
keyboardinterrupt: keyboardinterrupt 
restart: restart 
occurs: occurs 
prefixed: prefixed 
dtoa: dtoa 
cmath: cmath 
anymore: anymore 
ready: ready 
refcnt: refcnt 
counter: counter counters 
initvar: initvar 
exclude: exclude 
newreference: newreference 
forgetreference: forgetreference 
pytracemalloc: pytracemalloc 
getreftotal: getreftotal 
mechanism: mechanisms mechanism 
happened: happened 
clearing: clearing 
globals: globals 
guarantee: guarantee guarantees 
destruction: destruction 
vectorcallmethod: vectorcallmethod 
pyvectorcall: pyvectorcall 
callonearg: callonearg 
callmethodnoargs: callmethodnoargs 
callmethodonearg: callmethodonearg 
fastcalldict: fastcalldict 
tpflags: tpflags 
possibility: possibilities possibility 
awaiting: awaiting 
iterator: iterator 
topologicalsorter: topologicalsorter 
offer: offers 
perform: perform 
sorting: sorting 
graph: graphs 
tim: tim 
larry: larry 
hastings: hastings 
four: four 
publish: publish 
individual: individual 
looking: looking 
aenter: aenter 
aexit: aexit 
entering: entering 
ry: ry 
ogam: ogam 
lone: lone 
interactive: interactive 
folding: folding 
incorrent: incorrent 
binding: bindings binding 
distinct: distinct 
rich: rich 
exc: exc 
improves: improves 
clarity: clarity 
modest: modest 
speedup: speedup 
richcomparebool: richcomparebool 
buffered: buffered 
redirected: redirected 
unbuffered: unbuffered 
pythonunbuffered: pythonunbuffered 
jendrik: jendrik 
seipp: seipp 
holding: holding 
brotli: brotli 
br: br 
unsetenv: unsetenv 
copytree: copytree 
putenv: putenv 
setenv: setenv 
nextafter: nextafter 
william: william 
woodruff: woodruff 
accurate: accurate 
compression: compression 
gzip: gzip 
signaling: signaling 
maximum: maximum 
xpath: xpath 
xgtitle: xgtitle 
buffering: buffering 
opened: opened 
compresslevel: compresslevel 
hexbin: hexbin 
rlecode: rlecode 
rledecode: rledecode 
encodestring: encodestring 
decodestring: decodestring 
encodebytes: encodebytes 
decodebytes: decodebytes 
lmtp: lmtp 
refactoringtool: refactoringtool 
smtp: smtp 
ulp: ulp 
significant: significant 
distribution: distribution distributions 
discovery: discovery 
resilients: resilients 
inaccessible: inaccessible 
specify: specify 
equivalently: equivalently 
basename: basename 
floating: floating 
towards: towards 
gmane: gmane 
news: news 
guess: guess 
unnecessary: unnecessary 
cost: cost costs 
epoll: epoll 
unregister: unregister 
ebadf: ebadf 
ttk: ttk 
scale: scale scales 
giovanni: giovanni 
lombardo: lombardo 
thrown: thrown 
logger: loggers logger 
isenabledfor: isenabledfor 
say: say says 
stopit: stopit 
appropriately: appropriately 
resulting: resulting 
finally: finally 
side: side 
effect: effects effect 
spawning: spawning 
parenthesize: parenthesize 
lambda: lambdas lambda 
config: config 
dictconfig: dictconfig 
converting: converting 
convertingtuple: convertingtuple 
assumed: assumed 
treated: treated 
ordinary: ordinary 
timeouterror: timeouterror 
bypass: bypass bypasses 
leading: leading 
dot: dots 
category: category 
validate: validate 
stopall: stopall 
popen: popen 
completedprocess: completedprocess 
adjusted: adjusted 
wording: wording 
issued: issued 
author: author 
maintainer: maintainers maintainer 
mail: mail 
reflects: reflects 
suggested: suggested 
juergen: juergen 
gmach: gmach 
subclasshook: subclasshook 
inheritence: inheritence 
harel: harel 
applied: applied 
communicate: communicate 
piped: piped 
andriy: andriy 
maletsky: maletsky 
poll: poll polls 
polling: polling 
risk: risk 
returncode: returncode 
pid: pid 
reassigned: reassigned 
recycled: recycled 
formatted: formatted 
currency: currency 
international: international 
eur: eur 
autospecced: autospecced 
attached: attached 
attach: attach 
ident: ident 
separator: separator 
openlog: openlog 
deepcopy: deepcopy 
pstats: pstats 
stats: stats 
profile: profile 
statsprofile: statsprofile 
termios: termios 
baud: baud 
rate: rates rate 
andrey: andrey 
smirnov: smirnov 
nodetransformer: nodetransformer 
advice: advice 
ctags: ctags 
etags: etags 
dialog: dialogs dialog 
memoryview: memoryview 
etcetera: etcetera 
manual: manuals manual 
editor: editors editor 
indent: indent indents 
dead: dead 
pybytes: pybytes 
insertthousandsgroupinglocale: insertthousandsgroupinglocale 
insertthousandsgrouping: insertthousandsgrouping 
initializefromargs: initializefromargs 
initializefromwideargs: initializefromwideargs 
digit: digit digits 
digitsinit: digitsinit 
extendstack: extendstack 
pyaiterwrapper: pyaiterwrapper 
pynullimporter: pynullimporter 
pycmpwrapper: pycmpwrapper 
pysortwrapper: pysortwrapper 
pynoargsfunction: pynoargsfunction 
getexcinfo: getexcinfo 
retrieve: retrieve 
performing: performing 
uu: uu 
overflowing: overflowing 
modification: modification 
reuseaddr: reuseaddr 
udp: udp 
antoine: antoine 
pitrou: pitrou 
yury: yury 
selivanov: selivanov 
redos: redos 
cookiejar: cookiejar 
many: many 
kwargs: kwargs 
strengthening: strengthening 
assumption: assumption 
interned: interned 
among: among 
consistent: consistent 
lysandros: lysandros 
nikolaou: nikolaou 
argv: argv 
absolute: absolute 
expect: expect 
unmodified: unmodified 
regardless: regardless 
excepthook: excepthook 
mb: mb 
android: android 
singleton: singletons singleton 
nsmallnegints: nsmallnegints 
nsmallposints: nsmallposints 
modified: modified 
pystate: pystate 
pyfpe: pyfpe 
protect: protect 
sped: sped 
retaining: retaining 
ceil: ceil 
hongweipeng: hongweipeng 
sufficient: sufficient 
identification: identification 
generatorexit: generatorexit 
throwing: throwing 
cleanup: cleanup cleanups 
finish: finishes finish 
reraise: reraise 
generates: generates 
exceptional: exceptional 
replicated: replicated 
zipimport: zipimport 
improvement: improvements improvement 
entrypoints: entrypoints 
sslsocket: sslsocket 
invalidmessageid: invalidmessageid 
represent: represent 
defect: defect defects 
simplify: simplify 
tostring: tostring 
fromstring: fromstring 
tobytes: tobytes 
frombytes: frombytes 
accelerated: accelerated 
taskwakeupmethwrapper: taskwakeupmethwrapper 
pidfdchildwatcher: pidfdchildwatcher 
elsewhere: elsewhere 
childprocesserror: childprocesserror 
pidfd: pidfd 
noisy: noisy 
linked: linked 
libedit: libedit 
unboundlocalerror: unboundlocalerror 
improperly: improperly 
claudiu: claudiu 
popa: popa 
upgrade: upgrades upgrade 
rollover: rollover 
corrupt: corrupt 
serhiy: serhiy 
storchaka: storchaka 
choice: choices choice 
weight: weights 
keyerror: keyerror 
store: store stores 
seen: seen 
either: either 
binget: binget 
determined: determined 
bogus: bogus 
another: another 
endless: endless 
recursionerror: recursionerror 
consume: consume 
copied: copied 
avoiding: avoiding 
recursion: recursion 
newly: newly 
bruno: bruno 
kinoshita: kinoshita 
processing: processing 
decorated: decorated 
equivalent: equivalent 
parsed: parsed 
stopasynciteration: stopasynciteration 
exhaustion: exhaustion 
iterable: iterable 
impossible: impossible 
stopiteration: stopiteration 
cover: covers cover 
callables: callables 
track: tracks track 
downstream: downstream 
zac: zac 
hatfield: hatfield 
dodds: dodds 
unhandled: unhandled 
internationalizing: internationalizing 
nargs: nargs 
federico: federico 
bond: bond 
getpeercert: getpeercert 
toke: toke 
iland: iland 
rgensen: rgensen 
identified: identified 
indentation: indentation 
zipextfile: zipextfile 
underlying: underlying 
accessing: accessing 
decompose: decompose 
break: break breaks 
saving: saving 
dyld: dyld 
alive: alive 
mario: mario 
corchero: corchero 
dataclasses: dataclasses 
forward: forwards forward 
xinclude: xinclude 
mutually: mutually 
exclusive: exclusive 
indenting: indenting 
suppressing: suppressing 
compact: compact 
deps: deps 
activate: activate 
fish: fish 
strptime: strptime 
z: z 
karl: karl 
dubost: dubost 
ressources: ressources 
gced: gced 
leaking: leaking 
background: background 
completes: completes 
tracker: tracker 
hardcoded: hardcoded 
loopback: loopback 
internet: internet 
adjust: adjust 
every: every 
leader: leader 
sighup: sighup 
simply: simply 
fsum: fsum 
assert: assert 
ok: ok 
strip: strip strips 
whitespaces: whitespaces 
faulthandler: faulthandler 
gcc: gcc 
volatile: volatile 
tail: tail 
relying: relying 
pragma: pragma 
capi: capi 
lacking: lacking 
functional: functional 
bind: bind binds 
happen: happen 
sandbox: sandbox 
whitelist: whitelist 
adam: adam 
johnson: johnson 
receive: receive 
typererror: typererror 
ido: ido 
regen: regen 
solution: solution 
regenerate: regenerate 
opcodes: opcodes 
auditing: auditing 
releasing: releasing 
arm: arm 
osx: osx 
dynamic: dynamic 
initializing: initializing 
beno: beno 
hudson: hudson 
escape: escape escapes 
johnny: johnny 
najera: najera 
autocomplete: autocomplete 
appearing: appearing 
toggle: toggles toggle 
shortcut: shortcut shortcuts 
alt: alt 
mistakenly: mistakenly 
pymethod: pymethod 
stable: stable 
jason: jason 
killen: killen 
xmlrpc: xmlrpc 
docxmlrpcserver: docxmlrpcserver 
rendering: rendering 
vendorized: vendorized 
expat: expat 
unstructured: unstructured 
going: going 
ashwin: ashwin 
ramaswami: ramaswami 
abhilash: abhilash 
raj: raj 
hostname: hostname 
quad: quad 
notation: notation 
inet: inet 
aton: aton 
whatever: whatever 
poplib: poplib 
telnetlib: telnetlib 
listdir: listdir 
breakpoint: breakpoint 
com: com 
nd: nd 
maxking: maxking 
jpic: jpic 
getformat: getformat 
trunc: trunc 
slower: slower 
almost: almost 
similar: similar 
segmentation: segmentation 
fault: fault 
reverse: reverse 
iterators: iterators 
inada: inada 
naoki: naoki 
resurrect: resurrect 
reachable: reachable 
outside: outside 
finalizers: finalizers 
cyclic: cyclic 
collecting: collecting 
trash: trash 
however: however 
resurrected: resurrected 
visited: visited 
unecessary: unecessary 
intersection: intersections intersection 
dictview: dictview 
fedisableexcept: fedisableexcept 
became: became 
useless: useless 
interaction: interaction 
priority: priority 
warnoptions: warnoptions 
highest: highest 
stated: stated 
predict: predict 
pair: pair pairs 
awaits: awaits 
encountered: encountered 
visibility: visibility 
uniform: uniform 
across: across 
minimising: minimising 
stdio: stdio 
athrow: athrow 
annoying: annoying 
addmodule: addmodule 
compliant: compliant 
zlib: zlib 
pwd: pwd 
grp: grp 
posixsubprocess: posixsubprocess 
interpreterid: interpreterid 
channelid: channelid 
signed: signed 
silencing: silencing 
lookup: lookups lookup 
silenced: silenced 
difference: difference differences 
evgeny: evgeny 
kapun: kapun 
michele: michele 
orr: orr 
normalized: normalized 
greatly: greatly 
quick: quick 
generation: generation 
longobject: longobject 
lower: lower 
compilation: compilation 
partially: partially 
circular: circular 
negative: negatives negative 
sq: sq 
sergey: sergey 
fedoseev: fedoseev 
fromunsignedlong: fromunsignedlong 
fromunsignedlonglong: fromunsignedlonglong 
fromsize: fromsize 
importerror: importerror 
treating: treating 
lewis: lewis 
syntaxwarning: syntaxwarning 
described: described 
scoping: scoping 
ambiguous: ambiguous 
targetscopeerror: targetscopeerror 
originally: originally 
proposed: proposed 
favour: favour 
disallowed: disallowed 
gib: gib 
multibyte: multibyte 
span: spans 
chunk: chunk chunks 
boundary: boundaries boundary 
assertionerror: assertionerror 
shadowed: shadowed 
inconsistency: inconsistency inconsistencies 
place: places place 
needle: needle 
differing: differing 
wrapper: wrappers wrapper 
swap: swap 
posonlyargs: posonlyargs 
pymalloc: pymalloc 
pgo: pgo 
compute: compute 
getallocatedblocks: getallocatedblocks 
slows: slows 
malloc: malloc 
indicator: indicator 
printing: printing 
callstats: callstats 
getcheckinterval: getcheckinterval 
setcheckinterval: setcheckinterval 
getswitchinterval: getswitchinterval 
setswitchinterval: setswitchinterval 
interval: interval intervals 
checked: checked 
best: best 
surrogatepass: surrogatepass 
incremental: incremental 
decoder: decoders decoder 
fileinput: fileinput 
universal: universal 
k: k 
evaluated: evaluated 
unnecssary: unnecssary 
xincref: xincref 
classobject: classobject 
peephole: peephole 
optimizer: optimizer 
become: become 
allocator: allocator allocators 
obmalloc: obmalloc 
arena: arenas arena 
immediate: immediate 
thrashing: thrashing 
destroyed: destroyed 
anew: anew 
dispatching: dispatching 
mul: mul 
erroneous: erroneous 
pybuffer: pybuffer 
sizefromformat: sizefromformat 
calcsize: calcsize 
callable: callable 
unconditionally: unconditionally 
super: super 
netbsd: netbsd 
sum: sum 
cooper: cooper 
lee: lees lee 
pdbrc: pdbrc 
hopper: hopper 
dan: dan 
lidral: lidral 
porter: porter 
ti: tis 
nonexistent: nonexistent 
tactis: tactis 
centeuro: centeuro 
classmethod: classmethod 
written: written 
graham: graham 
dumpleton: dumpleton 
logic: logic 
su: su 
prohibit: prohibit 
parallel: parallel parallels 
asend: asend 
ag: ag 
actual: actual 
curse: curses 
doroschenko: doroschenko 
derived: derived 
trigger: trigger 
seekable: seekable 
append: append 
weakset: weakset 
mutableset: mutableset 
rotatinghandler: rotatinghandler 
namer: namer 
rotator: rotator 
eponymous: eponymous 
waitid: waitid 
watcher: watcher 
ofd: ofd 
getlk: getlk 
setlk: setlk 
setlkw: setlkw 
seeking: seeking 
backward: backward 
encrypted: encrypted 
escdelay: escdelay 
tabsize: tabsize 
fileconfig: fileconfig 
correcty: correcty 
asynci: asynci 
wakeup: wakeup 
windowspath: windowspath 
misspelled: misspelled 
noted: noted 
equality: equality 
cld: cld 
stopped: stopped 
si: si 
digestmod: digestmod 
clarified: clarified 
renamed: renamed 
umask: umask 
gh: gh 
introduces: introduces 
improper: improper 
samuel: samuel 
colvin: colvin 
ifdoor: ifdoor 
ifport: ifport 
ifwht: ifwht 
isdoor: isdoor 
isport: isport 
iswht: iswht 
suffix: suffix suffixes 
pickleable: pickleable 
propagating: propagating 
tkapptype: tkapptype 
splitlist: splitlist 
predicable: predicable 
smtpnotsupportederror: smtpnotsupportederror 
architecture: architectures architecture 
giampaolo: giampaolo 
rodola: rodola 
paste: paste 
clipboard: clipboard 
emoji: emoji 
pause: pause 
resume: resume 
detect: detect 
synchronous: synchronous 
asyncmocks: asyncmocks 
awaitevent: awaitevent 
want: wants want 
led: led 
face: face 
gzipfile: gzipfile 
pread: pread 
higher: higher 
limit: limit limits 
manipulation: manipulation 
inconsistent: inconsistent 
pow: pow 
descriptive: descriptive 
efficiency: efficiency 
changing: changing 
isdisjoint: isdisjoint 
cl: cls 
typename: typename 
tahia: tahia 
khan: khan 
insensitive: insensitive 
row: rows row 
indexing: indexing 
vice: vice 
versa: versa 
abraham: abraham 
toriz: toriz 
cruz: cruz 
preserve: preserve preserves 
hashing: hashing 
frome: frome 
naming: naming 
findlinestarts: findlinestarts 
lnotab: lnotab 
transport: transport transports 
escaping: escaping 
extract: extracts extract 
unsupported: unsupported 
pbkdf: pbkdf 
pointless: pointless 
gone: gone 
stay: stays 
protocol: protocol protocols 
identify: identify 
assuming: assuming 
threadpool: threadpool 
utilize: utilize 
getsockname: getsockname 
isotp: isotp 
closewalk: closewalk 
libc: libc 
fdwalk: fdwalk 
asynccontextmanagers: asynccontextmanagers 
asynciterators: asynciterators 
utctimetuple: utctimetuple 
utcnow: utcnow 
utcfromtimestamp: utcfromtimestamp 
evaluate: evaluate 
eq: eq 
forwardreferences: forwardreferences 
getattr: getattr 
isinstance: isinstance 
builtinimporter: builtinimporter 
sync: sync 
clarifying: clarifying 
requirement: requirement 
dist: dist 
info: info 
closure: closure 
modify: modify 
multiline: multiline 
indented: indented 
tee: tee 
internals: internals 
finalizer: finalizer 
del: del 
exactly: exactly 
scanstring: scanstring 
rmtree: rmtree 
boundedsemaphores: boundedsemaphores 
subscript: subscripts 
blhsing: blhsing 
ccompiler: ccompiler 
getpath: getpath 
nframe: nframe 
indicates: indicates 
preexec: preexec 
fn: fn 
restricted: restricted 
rusage: rusage 
incompletely: incompletely 
instantiation: instantiation 
iocp: iocp 
nodevisitor: nodevisitor 
methody: methody 
num: num 
verify: verify 
legal: legal 
reason: reason reasons 
appeared: appeared 
timezone: timezone 
tzinfo: tzinfo 
allocates: allocates 
connect: connect 
unset: unset 
deactivate: deactivate 
dataclass: dataclass 
something: something 
unable: unable 
establish: establish 
os: oses oss 
dedicated: dedicated 
sigstksz: sigstksz 
fastpath: fastpath 
inv: inv 
cdf: cdf 
isalive: isalive 
ratio: ratio 
pretty: pretty 
diff: diff 
dealing: dealing 
dirs: dirs 
ancestral: ancestral 
excluded: excluded 
xgettext: xgettext 
writelines: writelines 
bytesio: bytesio 
calendar: calendar 
guidance: guidance 
confusion: confusion 
definition: definitions definition 
stacksize: stacksize 
getlogger: getlogger 
instantiates: instantiates 
addch: addch 
color: colors color 
setcchar: setcchar 
yann: yann 
vaginay: vaginay 
completing: completing 
wsa: wsa 
timedelta: timedelta 
syncronize: syncronize 
improving: improving 
egg: egg 
contained: contained 
colon: colon colons 
unget: unget 
wch: wch 
determine: determine 
nester: nester 
let: let lets 
coordinate: coordinates 
iterables: iterables 
lt: lt 
play: play 
role: role 
powershell: powershell 
signing: signing 
bring: bring 
activation: activation 
minute: minutes minute 
minimum: minimum 
ngalim: ngalim 
siregar: siregar 
ttyname: ttyname 
safety: safety 
noncallablemock: noncallablemock 
matcher: matcher 
exists: exists 
elizabeth: elizabeth 
uselton: uselton 
leenders: leenders 
qualname: qualname 
unexpectedly: unexpectedly 
quoted: quoted 
marco: marco 
paolini: paolini 
recognize: recognize 
lc: lc 
ctype: ctype 
localename: localename 
compared: compared 
record: record records 
jn: jn 
kill: kills kill 
second: second seconds 
originator: originator 
daniel: daniel 
hillier: hillier 
identifies: identifies 
binop: binop 
capturing: capturing 
otherwise: otherwise 
connected: connected 
util: util 
temp: temp 
tempdir: tempdir 
reusing: reusing 
wininst: wininst 
mixin: mixin 
handshake: handshake 
authentication: authentication 
cert: cert certs 
auth: auth 
although: although 
sched: sched 
setaffinity: setaffinity 
getcwdb: getcwdb 
ansi: ansi 
rationale: rationale 
executemany: executemany 
quantiles: quantiles 
dataset: dataset 
marking: marking 
accelerator: accelerator 
pprint: pprint 
carl: carl 
bordum: bordum 
hansen: hansen 
grouping: grouping 
abbreviation: abbreviation 
justin: justin 
blanchard: blanchard 
formal: formal 
udplite: udplite 
hasattr: hasattr 
ipproto: ipproto 
cscov: cscov 
gabe: gabe 
appleton: appleton 
partial: partial 
aggregate: aggregate 
authorizer: authorizer 
progress: progress 
lead: leads lead 
segfaults: segfaults 
carefully: carefully 
aleksandr: aleksandr 
balezin: balezin 
socketcan: socketcan 
broadcast: broadcast 
bcm: bcm 
ding: ding 
htmlparser: htmlparser 
unescape: unescape 
webmanifest: webmanifest 
recognized: recognized 
aifc: aifc 
openfp: openfp 
sunau: sunau 
wave: wave 
accepting: accepting 
integral: integral 
factorial: factorial 
sends: sends 
wchar: wchar 
crashed: crashed 
pyton: pyton 
lzma: lzma 
decompresses: decompresses 
decompressing: decompressing 
alone: alone 
marker: marker 
dozen: dozens 
lin: lin 
robotfileparser: robotfileparser 
crawl: crawl 
relevant: relevant 
robot: robots 
txt: txt 
major: major 
eliminate: eliminate 
pyio: pyio 
iobase: iobase 
destructor: destructor 
getting: getting 
mimick: mimick 
basicconfig: basicconfig 
cooky: cookies 
expires: expires 
unintended: unintended 
getfile: getfile 
perm: perm 
mean: mean means 
giving: giving 
fmean: fmean 
switching: switching 
actionscontainer: actionscontainer 
someone: someone 
accidentally: accidentally 
filetype: filetype 
shinya: shinya 
okano: okano 
subprocesses: subprocesses 
lengthy: lengthy 
folded: folded 
jeffrey: jeffrey 
kintscher: kintscher 
transfer: transfer 
donnellan: donnellan 
proxyhandler: proxyhandler 
lowercase: lowercases lowercase 
zipinfo: zipinfo 
micka: micka 
l: l 
schoentgen: schoentgen 
despite: despite 
asserting: asserting 
belongs: belongs 
supplemental: supplemental 
threadpoolexecutor: threadpoolexecutor 
favor: favor 
gordon: gordon 
hemsley: hemsley 
enough: enough 
getchildren: getchildren 
getiterator: getiterator 
plistlib: plistlib 
reproducibly: reproducibly 
patrick: patrick 
mclean: mclean 
smtpd: smtpd 
mailmanproxy: mailmanproxy 
punctuation: punctuation 
action: action actions 
rpmbuild: rpmbuild 
aiudi: aiudi 
addr: addr 
delimiter: delimiter 
omits: omits 
know: know 
readlink: readlink 
girts: girts 
folkmanis: folkmanis 
unquote: unquote 
stein: stein 
karlsen: karlsen 
emily: emily 
morehouse: morehouse 
maxwell: maxwell 
mckinnon: mckinnon 
padded: padded 
modifier: modifiers modifier 
urlparse: urlparse 
scheme: scheme schemes 
deterministic: deterministic 
reinitialization: reinitialization 
singledispatch: singledispatch 
focusing: focusing 
caution: cautions 
modernize: modernize 
brazilian: brazilian 
portuguese: portuguese 
switcher: switcher 
website: website 
modernized: modernized 
addobject: addobject 
strongly: strongly 
clearly: clearly 
insecurity: insecurity 
dateutil: dateutil 
isoparse: isoparse 
fromisoformat: fromisoformat 
geturl: geturl 
esponse: esponse 
addinfourl: addinfourl 
deletecurrent: deletecurrent 
beginning: beginning 
edits: edits 
recommending: recommending 
getopt: getopt 
promote: promote 
brief: brief 
indicate: indicate 
mailbox: mailbox 
maildir: maildir 
attempt: attempts attempt 
folder: folders folder 
correctness: correctness 
sviatoslav: sviatoslav 
sydorenko: sydorenko 
insert: insert inserts 
benjamin: benjamin 
mintz: mintz 
finding: finding 
slash: slashes slash 
john: john 
mexico: mexico 
tech: tech 
chdir: chdir 
mike: mike 
gleen: gleen 
decompression: decompression 
pitfall: pitfalls 
depend: depend 
restructured: restructured 
interest: interest 
friendly: friendly 
readability: readability 
brad: brad 
solomon: solomon 
specifier: specifier 
cutoff: cutoff 
tuomas: tuomas 
suutari: suutari 
intended: intended 
regarding: regarding 
paper: paper 
setsid: setsid 
killpg: killpg 
serverproto: serverproto 
answer: answer 
hello: hello 
responsible: responsible 
maxlevels: maxlevels 
slowest: slowest 
buildbots: buildbots 
lto: lto 
de: de des 
traditional: traditional 
pkcs: pkcs 
aes: aes 
encryption: encryption 
availibility: availibility 
marked: marked 
mymanager: mymanager 
expects: expects 
sigterm: sigterm 
basemanager: basemanager 
slow: slow 
feeder: feeder 
donot: donot 
onexc: onexc 
coverage: coverage 
skipkeys: skipkeys 
enhance: enhance 
multiprocess: multiprocess 
killing: killing 
put: put 
rot: rot 
xxx: xxx 
cleaned: cleaned 
termination: terminations termination 
catching: catching 
forkserver: forkserver 
ask: ask 
xx: xx 
separated: separated 
temporaryfile: temporaryfile 
urlcleanup: urlcleanup 
urlretrieve: urlretrieve 
opener: opener 
urlopen: urlopen 
indirectly: indirectly 
outstanding: outstanding 
choose: choose 
necessary: necessary 
wsgiref: wsgiref 
testenviron: testenviron 
getgroups: getgroups 
getgrall: getgrall 
job: jobs job 
cleantest: cleantest 
purpose: purpose purposes 
proactorloopctrlc: proactorloopctrlc 
altered: altered 
env: env 
devpoll: devpoll 
isfreed: isfreed 
unit: unit units 
libressl: libressl 
differently: differently 
independent: independent 
ironpython: ironpython 
program: program programs 
obtain: obtain 
macaddr: macaddr 
basis: basis 
uncalled: uncalled 
naitree: naitree 
zhu: zhu 
misc: misc 
getvar: getvar 
stdatomic: stdatomic 
icc: icc 
lack: lack lacks 
atomic: atomic 
uintptr: uintptr 
reentrant: reentrant 
jes: jes 
cea: cea 
avi: avi 
locate: locate 
profdata: profdata 
ar: ar 
ac: ac 
gitignore: gitignore 
systematically: systematically 
rooted: rooted 
meant: meant 
repo: repo 
often: often 
anywhere: anywhere 
makeunicodedata: makeunicodedata 
unicodedata: unicodedata 
applies: applies 
git: git 
greg: greg 
price: price 
guided: guided 
clobber: clobber 
significantly: significantly 
likely: likely 
executable: executable 
factor: factor 
willing: willing 
care: care 
benchmark: benchmarks benchmark 
workload: workload 
pyrun: pyrun 
libpython: libpython 
mistake: mistake 
abi: abi 
sse: sse 
ossaudiodev: ossaudiodev 
spwd: spwd 
applicable: applicable 
rd: rd 
party: party 
packaging: packaging 
ncurses: ncurses 
asis: asis 
conflict: conflict conflicts 
officially: officially 
libcurses: libcurses 
panel: panel 
drive: drive drives 
ntpath: ntpath 
realpath: realpath 
microsoft: microsoft 
pythonw: pythonw 
pyw: pyw 
nul: nul 
sensitivity: sensitivity 
toolset: toolset 
unattend: unattend 
detected: detected 
winerror: winerror 
dup: dup 
ifchr: ifchr 
treat: treat treats 
surrogate: surrogate 
lstat: lstat 
findsharedfuncptrwindows: findsharedfuncptrwindows 
nyayapati: nyayapati 
explaining: explaining 
association: associations 
launch: launch 
app: app 
formatmessagew: formatmessagew 
unfinished: unfinished 
ruslan: ruslan 
kuprieiev: kuprieiev 
inheritable: inheritable 
tzname: tzname 
cp: cp 
reg: reg 
sz: sz 
strcasecmp: strcasecmp 
stricmp: stricmp 
minmin: minmin 
gong: gong 
bluetooth: bluetooth 
rfcomm: rfcomm 
vm: vm 
deep: deep 
setrlimit: setrlimit 
blink: blink 
general: general 
preference: preferences preference 
encodable: encodable 
exiting: exiting 
editorwindow: editorwindow 
terminal: terminal 
idlerc: idlerc 
discover: discover 
wrapping: wrapping 
unnecessarily: unnecessarily 
occasional: occasional 
hover: hover 
tooltip: tooltip 
cease: cease 
syntaxwarnings: syntaxwarnings 
syntaxerrors: syntaxerrors 
mousewheel: mousewheel 
george: george 
zhang: zhang 
reorder: reorder 
label: labels label 
expands: expands 
customize: customize 
recently: recently 
entered: entered 
optionally: optionally 
submitting: submitting 
showing: showing 
toggled: toggled 
unneeded: unneeded 
activity: activity 
occur: occur 
along: along 
inlining: inlining 
removefile: removefile 
simplifying: simplifying 
createconfighandlers: createconfighandlers 
focus: focus 
traversal: traversal 
refer: refer 
compensate: compensate 
subtract: subtract 
mostly: mostly 
transparent: transparent 
behind: behind 
zoom: zoom 
screen: screens screen 
momentarily: momentarily 
maximizing: maximizing 
particular: particular 
invalidate: invalidate 
saved: saved 
maximized: maximized 
reminder: reminder 
meaning: meaning 
obtrusive: obtrusive 
room: room 
customized: customized 
suppress: suppress 
normal: normal 
combine: combine 
paragraph: paragraph 
rstrip: rstrip 
valgrind: valgrind 
suppression: suppression 
alarm: alarms alarm 
strcmp: strcmp 
pathfix: pathfix 
assume: assume 
recursively: recursively 
argumentclinic: argumentclinic 
converter: converters converter 
cffi: cffi 
zipped: zipped 
pathscript: pathscript 
pythonrun: pythonrun 
depth: depth 
checkrecursionlimit: checkrecursionlimit 
pystructsequence: pystructsequence 
unnamedfield: unnamedfield 
refers: refers 
et: et 
lifetime: lifetime 
management: management 
referenced: referenced 
checkconsistency: checkconsistency 
decref: decref 
tyler: tyler 
kieft: kieft 
setpath: setpath 
getprogramfullpath: getprogramfullpath 
getprogramname: getprogramname 
setpythonhome: setpythonhome 
setprogramname: setprogramname 
pymemberdef: pymemberdef 
pygen: pygen 
needsfinalizing: needsfinalizing 
tested: tested 
addxoption: addxoption 
xoptions: xoptions 
setargvex: setargvex 
dealloc: dealloc 
functionstr: functionstr 
representation: representation 
jeroen: jeroen 
demeyer: demeyer 
callobject: callobject 
callfunction: callfunction 
callmethod: callmethod 
callobjectwithkeywords: callobjectwithkeywords 
pass: passes 
setwidestringlist: setwidestringlist 
meth: meth 
fastcall: fastcall 
pycode: pycode 
newwithposonlyargs: newwithposonlyargs 
posonlyargcount: posonlyargcount 
indicating: indicating 
positonal: positonal 
introduce: introduce 
callnoargs: callnoargs 
efficient: efficient 
callfunctionobjargs: callfunctionobjargs 
cast: cast casts 
asunsignedlonglongmask: asunsignedlonglongmask 
direntrytype: direntrytype 
scandiriteratortype: scandiriteratortype 
singular: singular 
plural: plural 
noun: noun 
instantiating: instantiating 
overriden: overriden 
disallowing: disallowing 
urlopener: urlopener 
fold: fold 
secure: secure 
memset: memset 
unpacking: unpacking 
hand: hand 
structseq: structseq 
argcount: argcount 
distinguish: distinguish 
tid: tid 
openbsd: openbsd 
pyast: pyast 
fromnodeobject: fromnodeobject 
freeing: freeing 
great: great 
usable: usable 
accomplished: accomplished 
leaving: leaving 
worst: worst 
quite: quite 
visibly: visibly 
matter: matter matters 
typically: typically 
thousand: thousand thousands 
simultaneously: simultaneously 
lenfunc: lenfunc 
sizeof: sizeof 
formattedvalue: formattedvalue 
possibly: possibly 
merged: merged 
adjacent: adjacent 
hexlify: hexlify 
inspired: inspired 
micropython: micropython 
memfd: memfd 
codetype: codetype 
nameindex: nameindex 
nametoindex: nametoindex 
indextoname: indextoname 
writeunraisable: writeunraisable 
normalizeexception: normalizeexception 
pyexception: pyexception 
settraceback: settraceback 
thing: things thing 
namedexpression: namedexpression 
away: away 
computation: computation 
modular: modular 
inverse: inverses inverse 
permitted: permitted 
third: third 
relatively: relatively 
prime: prime 
mro: mro 
hard: hard 
invalidation: invalidation 
frametype: frametype 
useful: useful 
apis: apis 
userlist: userlist 
slicing: slicing 
blahay: blahay 
erick: erick 
cervantes: cervantes 
vaultah: vaultah 
inherit: inherit 
debugging: debugging 
precede: precede 
followed: followed 
sign: signs sign 
conversion: conversions conversion 
live: live 
aligned: aligned 
conform: conform 
recent: recent 
alignment: alignment 
meaningless: meaningless 
getpid: getpid 
combination: combination combinations 
deal: deal deals 
deallocation: deallocation 
cross: cross 
ticket: tickets 
tlsv: tlsv 
summaryinformation: summaryinformation 
getproperty: getproperty 
sealing: sealing 
memfds: memfds 
introspection: introspection 
component: component components 
keyfile: keyfile 
coro: coro 
publicly: publicly 
unreasonably: unreasonably 
uncaught: uncaught 
textiowrapper: textiowrapper 
checkable: checkable 
autospeccing: autospeccing 
qualifier: qualifier 
propagated: propagated 
pollute: pollute 
dino: dino 
viehland: viehland 
safe: safe 
cancellederror: cancellederror 
baseexception: baseexception 
clause: clause 
breaking: breaking 
inheriting: inheriting 
invalidstateerror: invalidstateerror 
counterpart: counterpart counterparts 
supportsindex: supportsindex 
bufsize: bufsize 
openhook: openhook 
delayed: delayed 
licht: licht 
takeuchi: takeuchi 
copystat: copystat 
einval: einval 
setxattr: setxattr 
copying: copyings copying 
filesystems: filesystems 
ying: ying 
wang: wang 
sake: sake 
def: def 
rmod: rmod 
drain: drain 
merges: merges 
streamreader: streamreader 
streamwriter: streamwriter 
readonly: readonly 
writeonly: writeonly 
readwrite: readwrite 
factory: factories factory 
streamserver: streamserver 
unixstreamserver: unixstreamserver 
serve: serve 
flowcontrolmixing: flowcontrolmixing 
streamreaderprotocol: streamreaderprotocol 
construction: construction 
ip: ips ip 
argparser: argparser 
sharedmemorymanager: sharedmemorymanager 
pygram: pygram 
perf: perf 
discarding: discarding 
ensuring: ensuring 
isqrt: isqrt 
square: squares square 
provisional: provisional 
alphanumeric: alphanumeric 
requiring: requiring 
permit: permits permit 
formation: formations 
aviv: aviv 
palivoda: palivoda 
writeable: writeable 
introducing: introducing 
spawnp: spawnp 
waitformultipleobjects: waitformultipleobjects 
limitation: limitation 
queuelistener: queuelistener 
stopping: stopping 
forbid: forbid 
band: band 
straight: straight 
badgzipfile: badgzipfile 
simpleserver: simpleserver 
threaded: threaded 
wsgiserver: wsgiserver 
silent: silent 
basehandler: basehandler 
specifying: specifying 
forked: forked 
forking: forking 
chained: chained 
acquisition: acquisition 
guaranteed: guaranteed 
reduction: reduction 
th: th 
setstate: setstate 
registration: registration 
reducer: reducer 
ctrl: ctrl 
sent: sent 
dictwriter: dictwriter 
writeheader: writeheader 
ashish: ashish 
nitin: nitin 
patil: patil 
mo: mo 
plist: plist 
keyedarchive: keyedarchive 
shield: shield 
selectoreventloop: selectoreventloop 
niklas: niklas 
fiekas: fiekas 
comb: comb 
binomial: binomial 
coefficient: coefficient 
computes: computes 
repetition: repetition 
yash: yash 
aggarwal: aggarwal 
keller: keller 
fuchs: fuchs 
temporarydirectory: temporarydirectory 
searchable: searchable 
material: material 
sslkeylogfile: sslkeylogfile 
coroutines: coroutines 
lisa: lisa 
roach: roach 
linesep: linesep 
jens: jens 
troeger: troeger 
streamrecoder: streamrecoder 
ammar: ammar 
askar: askar 
bo: bo 
bayles: bayles 
reply: replies 
spinning: spinning 
cwd: cwd 
anders: anders 
lorentsen: lorentsen 
unlink: unlink 
buchholz: buchholz 
madvise: madvise 
disk: disk disks 
commonly: commonly 
francisco: francisco 
facioni: facioni 
patched: patched 
vadim: vadim 
tsander: tsander 
shallow: shallow 
loss: loss 
unstable: unstable 
various: various 
std: std 
actually: actually 
addstr: addstr 
fromtimeandfold: fromtimeandfold 
fromdateandtimeandfold: fromdateandtimeandfold 
edison: edison 
abahurire: abahurire 
legacy: legacy 
pruned: pruned 
retained: retained 
solely: solely 
independently: independently 
unwrap: unwrap 
glossary: glossary 
mutablesequence: mutablesequence 
expand: expand 
clearer: clearer 
cprofile: cprofile 
captured: captured 
failfast: failfast 
selfsigned: selfsigned 
pythontestdotnet: pythontestdotnet 
pem: pem 
pythontest: pythontest 
net: net 
ib: ib 
networking: networking 
distro: distro 
functioning: functioning 
sem: sem 
lpython: lpython 
msc: msc 
proactor: proactor 
meily: meily 
xcode: xcode 
idlelib: idlelib 
systemexit: systemexit 
fsync: fsync 
flushed: flushed 
usb: usb 
extraneous: extraneous 
chih: chih 
hsuan: hsuan 
yen: yen 
modulo: modulo 
ipow: ipow 
callmethodobjargs: callmethodobjargs 
callmethodidobjargs: callmethodidobjargs 
getmethod: getmethod 
sullivan: sullivan 
behaving: behaving 
unbound: unbound 
supporting: supporting 
reinitthreads: reinitthreads 
afterfork: afterfork 
mishandling: mishandling 
urlsplit: urlsplit 
confstr: confstr 
defpath: defpath 
look: look looks 
pgen: pgen 
serialno: serialno 
footprint: footprint 
decide: decide 
pymem: pymem 
recommended: recommended 
startswith: startswith 
capitalize: capitalize 
titlecase: titlecase 
uppercase: uppercase 
acquirelock: acquirelock 
acquirethread: acquirethread 
pycarraytype: pycarraytype 
cookie: cookie 
certain: certain 
perl: perl 
tok: tok 
nextc: nextc 
classmethoddescr: classmethoddescr 
parsererror: parsererror 
skrobov: skrobov 
wildcards: wildcards 
inplace: inplace 
gained: gained 
serialisation: serialisation 
matrix: matrix 
multiplication: multiplication 
xmlpullparser: xmlpullparser 
miss: miss misses 
getcwd: getcwd 
ipnetwork: ipnetwork 
timer: timers timer 
gettimeofday: gettimeofday 
timing: timing timings 
impacted: impacted 
monotonic: monotonic 
matthias: matthias 
bussonnier: bussonnier 
prefers: prefers 
lean: lean 
backlog: backlog 
mktime: mktime 
rougeth: rougeth 
response: responses response 
debuglevel: debuglevel 
houglum: houglum 
geometric: geometric 
normcase: normcase 
relies: relies 
fspath: fspath 
wolfgang: wolfgang 
maier: maier 
octet: octets 
ambiguously: ambiguously 
octal: octal 
cdata: cdata 
vladimir: vladimir 
surjaninov: surjaninov 
unstarted: unstarted 
idempotent: idempotent 
logout: logout 
faiures: faiures 
tostringlist: tostringlist 
alternate: alternate 
fromisocalendar: fromisocalendar 
iso: iso 
week: week weeks 
weekday: weekday 
initializer: initializer 
encountering: encountering 
dualstack: dualstack 
convenience: convenience 
automate: automate 
usually: usually 
staticmethod: staticmethod 
felipe: felipe 
ochoa: ochoa 
transparency: transparency 
photoimage: photoimage 
abrupt: abrupt 
gracefully: gracefully 
petter: petter 
strandmark: strandmark 
sax: sax 
stale: stale 
happy: happy 
eyeball: eyeballs 
interleave: interleave 
isgeneratorfunction: isgeneratorfunction 
iscoroutinefunction: iscoroutinefunction 
isasyncgenfunction: isasyncgenfunction 
reused: reused 
restructuredtext: restructuredtext 
directive: directive directives 
chinese: chinese 
duplication: duplication 
literalinclude: literalinclude 
st: st 
phane: phane 
wirtel: wirtel 
documention: documention 
contributing: contributing 
stub: stubs stub 
groupdict: groupdict 
howto: howto 
uncollectable: uncollectable 
findleaks: findleaks 
elapsed: elapsed 
sleep: sleep 
upper: upper 
testinternalcapi: testinternalcapi 
enetunreach: enetunreach 
hunting: hunting 
delta: deltas delta 
warmup: warmup 
everything: everything 
hunt: hunt 
rlimit: rlimit 
fsize: fsize 
tabnanny: tabnanny 
enoent: enoent 
testcapi: testcapi 
allocation: allocations allocation 
scriptsinstall: scriptsinstall 
cygwin: cygwin 
rtld: rtld 
soabi: soabi 
disabling: disabling 
impact: impact 
pymodinit: pymodinit 
pyport: pyport 
fmax: fmax 
align: align 
cflags: cflags 
aligns: aligns 
movaps: movaps 
instruct: instruct 
movups: movups 
sigsegv: sigsegv 
sadly: sadly 
nodist: nodist 
implies: implies 
ref: refs ref 
incompatibility: incompatibility incompatibilities 
getobjects: getobjects 
pythondumprefs: pythondumprefs 
ldflags: ldflags 
linkforshared: linkforshared 
executables: executables 
iot: iot 
codepage: codepage 
chcp: chcp 
lorenz: lorenz 
mende: mende 
preset: preset 
container: containers container 
ui: ui 
wide: wide 
enterprise: enterprise 
crls: crls 
revocation: revocation 
ah: ah 
cbt: cbt 
dstopts: dstopts 
egp: egp 
esp: esp 
fragment: fragments fragment 
ggp: ggp 
hopopts: hopopts 
iclfxbm: iclfxbm 
icmpv: icmpv 
idp: idp 
igmp: igmp 
igp: igp 
pgm: pgm 
pim: pim 
pup: pup 
rdp: rdp 
routing: routing 
sctp: sctp 
libffi: libffi 
jeremy: jeremy 
kloth: kloth 
creator: creators 
elevated: elevated 
reverts: reverts 
forced: forced 
pyshell: pyshell 
bottom: bottom 
lll: lll 
setstandardstreamencoding: setstandardstreamencoding 
const: const 
cleanbyte: cleanbyte 
deaddyte: deaddyte 
forbiddenbyte: forbiddenbyte 
setupdebughooks: setupdebughooks 
xcb: xcb 
xdb: xdb 
xfb: xfb 
xcd: xcd 
xdd: xdd 
xfd: xfd 
crt: crt 
decodelocale: decodelocale 
mojibake: mojibake 
coerced: coerced 
preinitialize: preinitialize 
pypreconfig: pypreconfig 
pydate: pydate 
fromtimestamp: fromtimestamp 
timestamp: timestamp 
refcount: refcount 
refcounts: refcounts 
decreasing: decreasing 
idna: idna 
nfkc: nfkc 
defaultcookiepolicy: defaultcookiepolicy 
parsermodule: parsermodule 
dfa: dfa 
arc: arcs arc 
consts: consts 
prepended: prepended 
truncating: truncating 
pybuilddir: pybuilddir 
fini: fini 
fewer: fewer 
unlikely: unlikely 
dg: dg 
strtod: strtod 
marshal: marshal 
occurring: occurring 
heterogeneous: heterogeneous 
elliot: elliot 
gorokhovsky: gorokhovsky 
vestige: vestiges 
martijn: martijn 
pieters: pieters 
getdict: getdict 
tweaking: tweaking 
hack: hacks hack 
reinstated: reinstated 
driver: driver 
retire: retire 
carried: carried 
computing: computing 
cumulative: cumulative 
spelling: spellings 
modulenotfounderror: modulenotfounderror 
mental: mental 
pax: pax 
vendor: vendor 
gerlach: gerlach 
stephan: stephan 
hohe: hohe 
stderrprinter: stderrprinter 
reprs: reprs 
malcolm: malcolm 
hashopenssl: hashopenssl 
overlapping: overlapping 
copyfileobj: copyfileobj 
kib: kib 
stepping: stepping 
erroneously: erroneously 
direntry: direntry 
formatwarning: formatwarning 
tashrif: tashrif 
billah: billah 
clash: clash clashes 
libm: libm 
sinpi: sinpi 
dmitrii: dmitrii 
pasechnik: pasechnik 
henry: henry 
chen: chen 
filecookiejar: filecookiejar 
ie: ie 
assisted: assisted 
kumar: kumar 
akshay: akshay 
pp: pp 
pformat: pformat 
prettyprinter: prettyprinter 
namespacepath: namespacepath 
chmod: chmod 
librates: librates 
cfg: cfg 
scalar: scalars scalar 
programming: programming 
faq: faq 
explaines: explaines 
posixuidgidtests: posixuidgidtests 
getpreferredencoding: getpreferredencoding 
getlocale: getlocale 
sanitizer: sanitizer 
ffi: ffi 
pc: pc 
fgbg: fgbg 
gethighlight: gethighlight 
popup: popup 
dark: dark 
theme: themes theme 
darken: darken 
findfiles: findfiles 
colorizer: colorizer 
colordelegator: colordelegator 
blurry: blurry 
kevin: kevin 
walzer: walzer 
louie: louie 
lu: lu 
whole: whole 
coreconfig: coreconfig 
assigning: assigning 
doubled: doubled 
writes: writes 
dunder: dunder 
manner: manner 
terminated: terminated 
batch: batch 
understand: understand 
asked: asked 
subscriptable: subscriptable 
metaclass: metaclass 
randommodule: randommodule 
richcompare: richcompare 
stolen: stolen 
cell: cell 
celltype: celltype 
pierre: pierre 
glaser: glaser 
condattr: condattr 
setclock: setclock 
comma: commas comma 
missed: missed 
guarded: guarded 
sanyam: sanyam 
khurana: khurana 
operates: operates 
owns: owns 
ob: ob 
manipulating: manipulating 
composite: composite 
measurement: measurement 
syncmanager: syncmanager 
susan: susan 
rely: rely 
getaddrinfo: getaddrinfo 
dual: dual 
frozen: frozen 
nina: nina 
zakharenko: zakharenko 
findall: findall 
scan: scan 
disappearing: disappearing 
prod: prod 
analogous: analogous 
product: product 
arithmetic: arithmetic 
astimezone: astimezone 
tz: tz 
retain: retain 
serverproxy: serverproxy 
safetransport: safetransport 
dric: dric 
krier: krier 
locking: locking 
thereby: thereby 
burgess: burgess 
pycs: pycs 
manpage: manpage 
synopsis: synopsis 
bump: bump 
guionly: guionly 
comboboxtest: comboboxtest 
cocoa: cocoa 
rhel: rhel 
shareable: shareable 
supposed: supposed 
xztar: xztar 
maxdata: maxdata 
aixtools: aixtools 
mimic: mimic mimics 
pcbuild: pcbuild 
existence: existence 
invoking: invoking 
profiling: profiling 
revise: revise 
unittests: unittests 
deref: deref 
crl: crl 
dp: dp 
uri: uri 
buggy: buggy 
talos: talos 
colin: colin 
nicolas: nicolas 
edet: edet 
cisco: cisco 
domreg: domreg 
dtd: dtd 
initializes: initializes 
randomization: randomization 
salt: salt 
hashsecret: hashsecret 
libexpat: libexpat 
csprng: csprng 
trailer: trailers 
harden: harden 
namelen: namelen 
minimal: minimal 
overrun: overrun 
regexes: regexes 
vulnerable: vulnerable 
formed: formed 
do: dos 
vector: vectors 
jamie: jamie 
davis: davis 
idn: idn 
en: en 
sni: sni 
merging: merging 
thereof: thereof 
typed: typed 
reorganize: reorganize 
pymain: pymain 
cmdline: cmdline 
impl: impl 
instrumentation: instrumentation 
fromformat: fromformat 
past: past 
precision: precision 
deleting: deleting 
unbalanced: unbalanced 
semantic: semantic 
insignificant: insignificant 
magicproxy: magicproxy 
kall: kall 
widely: widely 
undecodable: undecodable 
pythoncoerceclocale: pythoncoerceclocale 
coerce: coerce 
brace: braces brace 
formatter: formatter 
nature: nature 
forbidden: forbidden 
elvis: elvis 
pranskevichus: pranskevichus 
stefano: stefano 
rivera: rivera 
accepted: accepted 
alg: alg 
nonlocal: nonlocal 
declared: declared 
mutated: mutated 
iterated: iterated 
bytesobject: bytesobject 
newtype: newtype 
structsequences: structsequences 
identity: identity 
ints: ints 
accident: accident 
advises: advises 
descr: descr 
really: really 
worth: worth 
xxhash: xxhash 
pathological: pathological 
additionally: additionally 
substantial: substantial 
contribution: contributions 
timemodule: timemodule 
pointed: pointed 
affecting: affecting 
critical: critical 
simpleparsestringfilename: simpleparsestringfilename 
restrict: restrict 
arg: arg 
resizing: resizing 
pruning: pruning 
setlocale: setlocale 
surrogateescape: surrogateescape 
pythonioencoding: pythonioencoding 
bootlocale: bootlocale 
encodelocale: encodelocale 
getfilesystemencoding: getfilesystemencoding 
tracebacks: tracebacks 
subexpressions: subexpressions 
subexpression: subexpression 
leakage: leakage 
interoperable: interoperable 
filemode: filemode 
od: od 
constantin: constantin 
petrisor: petrisor 
frozensets: frozensets 
concatenation: concatenation concatenations 
pythonmalloc: pythonmalloc 
varnames: varnames 
tokenizing: tokenizing 
interruption: interruptions interruption 
gettotalrefcount: gettotalrefcount 
vendored: vendored 
simplefileexflags: simplefileexflags 
evalcode: evalcode 
builtinmethodtype: builtinmethodtype 
moduletype: moduletype 
methodwrappertype: methodwrappertype 
hamt: hamt 
tracking: tracking 
seven: seven 
pyiter: pyiter 
pyexceptionclass: pyexceptionclass 
automatic: automatic 
christoph: christoph 
gohlke: gohlke 
sig: sig 
dfl: dfl 
philipp: philipp 
kerling: kerling 
view: views view 
classcell: classcell 
pythonpycacheprefix: pythonpycacheprefix 
pycache: pycache 
pyhash: pyhash 
miscellaneous: miscellaneous 
setpgroup: setpgroup 
resetids: resetids 
setsigmask: setsigmask 
setsigdef: setsigdef 
scheduler: scheduler 
symmetric: symmetric 
unaligned: unaligned 
siphash: siphash 
rolf: rolf 
eike: eike 
beer: beer 
pathfinder: pathfinder 
appear: appear 
meta: meta 
salgado: salgado 
ubsan: ubsan 
dictobject: dictobject 
adjusting: adjusting 
dictkeysobject: dictkeysobject 
numerical: numerical 
allocate: allocate 
intern: intern 
anonymous: anonymous 
toreadonly: toreadonly 
memoryviews: memoryviews 
normalizestring: normalizestring 
growth: growth 
round: round rounds 
power: power 
shrinked: shrinked 
chance: chance 
sharing: sharing 
copyable: copyable 
serialize: serialize 
bronson: bronson 
jumping: jumping 
corrupts: corrupts 
getattro: getattro 
deletes: deletes 
classdef: classdef 
functiondef: functiondef 
asyncfunctiondef: asyncfunctiondef 
revealing: revealing 
consisting: consisting 
rang: rang 
moving: moving 
unrolling: unrolling 
cleaning: cleaning 
outermost: outermost 
rest: rest 
cuthbert: cuthbert 
jordan: jordan 
chapman: chapman 
asyncfor: asyncfor 
asyncwith: asyncwith 
tell: tell 
structured: structured 
eryk: eryk 
sun: sun 
utime: utime 
getsockaddrarg: getsockaddrarg 
asdict: asdict 
exitstack: exitstack 
ever: ever 
others: others 
leaked: leaked 
risc: risc 
submodule: submodule 
arising: arising 
orphan: orphan 
trapped: trapped 
toggling: toggling 
misordering: misordering 
reduced: reduced 
half: half 
counting: counting 
iocpproactor: iocpproactor 
queuehandler: queuehandler 
modifying: modifying 
enqueueing: enqueueing 
hypot: hypot 
overlapped: overlapped 
readfile: readfile 
wsasend: wsasend 
itemgetter: itemgetter 
typical: typical 
metaclasses: metaclasses 
signum: signum 
divmod: divmod 
gammavariate: gammavariate 
expovariate: expovariate 
synchronizes: synchronizes 
eliminates: eliminates 
idiosyncrasy: idiosyncrasies 
delaying: delaying 
joke: joke 
barry: barry 
flufl: flufl 
selinux: selinux 
alert: alert 
texttestrunner: texttestrunner 
runner: runner 
baseprocess: baseprocess 
createprocessw: createprocessw 
dropped: dropped 
macpath: macpath 
unblock: unblock 
keyboard: keyboard 
received: received 
clonenode: clonenode 
repeated: repeated 
fileno: fileno 
rhapsody: rhapsody 
utils: utils 
getpwuid: getpwuid 
password: password passwords 
oran: oran 
avraham: avraham 
tcp: tcp 
nodelay: nodelay 
ismo: ismo 
toijala: toijala 
redirects: redirects 
devnull: devnull 
strftime: strftime 
darwin: darwin 
parseerror: parseerror 
trip: trip 
stripping: stripping 
fancy: fancy 
murray: murray 
jairo: jairo 
trad: trad 
enhanced: enhanced 
localeconv: localeconv 
monetary: monetary 
ancestor: ancestors 
suggests: suggests 
fnctl: fnctl 
eintr: eintr 
flock: flock 
lockf: lockf 
calcellation: calcellation 
rpm: rpm 
dumb: dumb 
gb: gb 
incrementalnewlinedecoder: incrementalnewlinedecoder 
translate: translate 
untrack: untrack 
performed: performed 
forget: forget 
sequencemanager: sequencemanager 
gettext: gettext 
artifact: artifacts 
charset: charset 
socketserver: socketserver 
baseserver: baseserver 
forever: forever 
wrote: wrote 
redundantly: redundantly 
quentin: quentin 
agren: agren 
abspath: abspath 
grandchild: grandchildren 
kuska: kuska 
cmsg: cmsg 
ancillary: ancillary 
recvfds: recvfds 
former: former 
portable: portable 
mbox: mbox 
successfully: successfully 
compress: compress 
smaller: smaller 
tradeoff: tradeoff 
execfile: execfile 
fixer: fixer 
rb: rb 
mayank: mayank 
asthana: asthana 
moveto: moveto 
canvas: canvas 
widget: widget widgets 
juliette: juliette 
monsel: monsel 
findtext: findtext 
spinbox: spinbox 
websocket: websocket 
hexdigest: hexdigest 
testcase: testcase 
subtests: subtests 
oliveira: oliveira 
enhancement: enhancement 
fmt: fmt 
strformatstyle: strformatstyle 
percentstyle: percentstyle 
stringtemplatestyle: stringtemplatestyle 
nominal: nominal 
polluted: polluted 
mtime: mtime 
reproducible: reproducible 
guo: guo 
teo: teo 
mingw: mingw 
symbolic: symbolic 
fieldstorage: fieldstorage 
harder: harder 
limiting: limiting 
minifieldstorage: minifieldstorage 
noise: noise 
epoch: epoch 
deviating: deviating 
wasm: wasm 
andr: andr 
delfino: delfino 
logrecord: logrecord 
represents: represents 
nameconstant: nameconstant 
ellipsis: ellipsis 
accumulate: accumulate 
musl: musl 
awrite: awrite 
providing: providing 
flow: flow 
switched: switched 
ing: ing 
lchmod: lchmod 
scanning: scanning 
microoptimization: microoptimization 
addmodulecleanup: addmodulecleanup 
addclasscleanup: addclasscleanup 
setupmodule: setupmodule 
setupclass: setupclass 
astuple: astuple 
namedtuples: namedtuples 
dictproxy: dictproxy 
getpwnam: getpwnam 
getgrnam: getgrnam 
invisible: invisible 
grzybowski: grzybowski 
wouter: wouter 
bolsterlee: bolsterlee 
winapi: winapi 
peeknamedpipe: peeknamedpipe 
enummeta: enummeta 
tokenize: tokenize 
underflow: underflow 
streamed: streamed 
silas: silas 
sewell: sewell 
alexey: alexey 
izbyshev: izbyshev 
getsourcelines: getsourcelines 
matveev: matveev 
strsignal: strsignal 
associate: associate 
mjs: mjs 
javascript: javascript 
ill: ill 
appending: appending 
grows: grows 
framesummary: framesummary 
assertraises: assertraises 
assertraisesregex: assertraisesregex 
assertwarns: assertwarns 
assertwarnsregex: assertwarnsregex 
pulldom: pulldom 
domeventstream: domeventstream 
filewrapper: filewrapper 
receives: receives 
ndbm: ndbm 
zsolt: zsolt 
cserna: cserna 
euclidean: euclidean 
distance: distance 
modifies: modifies 
blum: blum 
aguiar: aguiar 
franz: franz 
woellert: woellert 
wright: wright 
dml: dml 
writable: writable 
homedir: homedir 
dimension: dimensions 
pythontracemalloc: pythontracemalloc 
helpformatter: helpformatter 
zbyszek: zbyszek 
drzejewski: drzejewski 
szmek: szmek 
conflicted: conflicted 
unhashable: unhashable 
skipinitialspace: skipinitialspace 
doublequote: doublequote 
dialect: dialect 
adapt: adapt 
reload: reload 
showtopic: showtopic 
topic: topics topic 
tty: tty 
reject: reject rejects 
shim: shim shims 
uncompress: uncompress 
startupinfo: startupinfo 
opera: opera 
bumsik: bumsik 
kim: kim 
dictreader: dictreader 
selik: selik 
reconfiguration: reconfiguration 
wikipedia: wikipedia 
rosette: rosette 
describing: describing 
draw: draws 
penrose: penrose 
eliminated: eliminated 
subnormal: subnormal 
occasionally: occasionally 
readv: readv 
writev: writev 
preadv: preadv 
pwritev: pwritev 
compressor: compressors compressor 
decompressors: decompressors 
stealing: stealing 
steal: steal 
smb: smb 
syscalls: syscalls 
especially: especially 
decompressor: decompressor 
sizehint: sizehint 
proactorsockettransport: proactorsockettransport 
putting: putting 
lexists: lexists 
isdir: isdir 
isfile: isfile 
islink: islink 
ismount: ismount 
fifo: fifo 
unicodeencodeerror: unicodeencodeerror 
unrepresentable: unrepresentable 
qsl: qsl 
pythonstartup: pythonstartup 
steve: steve 
weber: weber 
decoded: decoded 
timo: timo 
furrer: furrer 
utcoffset: utcoffset 
naive: naive 
configparser: configparser 
assigned: assigned 
encoder: encoder 
enrique: enrique 
perez: perez 
terron: terron 
enc: enc 
availability: availability 
windowsselectoreventlooppolicy: windowsselectoreventlooppolicy 
windowsproactoreventlooppolicy: windowsproactoreventlooppolicy 
removeattributenode: removeattributenode 
attr: attr 
complies: complies 
stacklevel: stacklevel 
ssltransport: ssltransport 
aborted: aborted 
controller: controller 
pgettext: pgettext 
parameterkind: parameterkind 
copyfile: copyfile 
efficiently: efficiently 
bigger: bigger 
mib: mib 
consumed: consumed 
sslprotocol: sslprotocol 
sslproto: sslproto 
selectorsockettransport: selectorsockettransport 
cython: cython 
bufferedprotocol: bufferedprotocol 
bufferedprotocols: bufferedprotocols 
proof: proof 
haydaman: haydaman 
preliminary: preliminary 
getgrgid: getgrgid 
sigsgv: sigsgv 
wrappable: wrappable 
metavar: metavar 
finishing: finishing 
fo: fos 
planned: planned 
formatargspec: formatargspec 
computed: computed 
life: life lives 
cipher: cipher ciphers 
employee: employee 
simplification: simplification 
forkingmixin: forkingmixin 
threadingmixin: threadingmixin 
consider: consider 
subparsers: subparsers 
localetime: localetime 
pad: pad 
duid: duid 
zvi: zvi 
effron: effron 
readtransport: readtransport 
classvar: classvar 
lady: lady 
red: red 
wirtz: wirtz 
reordering: reordering 
twisted: twisted 
amber: amber 
brown: brown 
scott: scott 
sanderson: sanderson 
isdatadescriptor: isdatadescriptor 
aaron: aaron 
hall: hall 
doctype: doctype 
pendingdeprecationwarning: pendingdeprecationwarning 
kwds: kwds 
pr: prs 
paulius: paulius 
arka: arka 
chad: chad 
dombrova: dombrova 
besides: besides 
strigl: strigl 
quotation: quotation 
cgitb: cgitb 
blondon: blondon 
complement: complements 
tony: tony 
flury: flury 
dynamically: dynamically 
sigfillset: sigfillset 
glibcs: glibcs 
nop: nop 
quoting: quoting 
simplecookie: simplecookie 
rf: rf 
respected: respected 
contextlib: contextlib 
asyncexitstack: asyncexitstack 
starostin: starostin 
produced: produced 
got: got 
relied: relied 
randrange: randrange 
arbitrarily: arbitrarily 
samesite: samesite 
importer: importer 
consistently: consistently 
mdiff: mdiff 
framing: framing 
robotparser: robotparser 
wildcard: wildcard 
appended: appended 
lazar: lazar 
bumped: bumped 
singledispatchmethod: singledispatchmethod 
dispatch: dispatch 
treeview: treeview 
iid: iid 
garvit: garvit 
khatri: khatri 
getvalue: getvalue 
memberdescriptortype: memberdescriptortype 
inherits: inherits 
submit: submit 
noreturn: noreturn 
fstat: fstat 
urandom: urandom 
nir: nir 
soffer: soffer 
casting: casting 
eaton: eaton 
receiving: receiving 
subclasscheck: subclasscheck 
partialmethods: partialmethods 
audio: audio 
disassembly: disassembly 
redirection: redirection 
relaxed: relaxed 
itn: itn 
joffrey: joffrey 
fuhrer: fuhrer 
renegotiation: renegotiation 
sslobject: sslobject 
prohibited: prohibited 
designed: designed 
suppose: suppose 
tri: tri 
middlebox: middlebox 
compat: compat 
npn: npn 
encodes: encodes 
getfinalpathname: getfinalpathname 
getvolumepathname: getvolumepathname 
getdiskusage: getdiskusage 
confusing: confusing 
helpful: helpful 
canceling: canceling 
cheryl: cheryl 
sabella: sabella 
notifying: notifying 
conditional: conditional 
fastopen: fastopen 
keepcnt: keepcnt 
keepidle: keepidle 
keepintvl: keepintvl 
guessing: guessing 
sniffer: sniffer 
sniff: sniff 
jake: jake 
jonathan: jonathan 
eunice: eunice 
indirect: indirect 
linking: linking 
dlopen: dlopen 
libdl: libdl 
dl: dl 
timerhandle: timerhandle 
acquiring: acquiring 
envelope: envelope 
tlsversion: tlsversion 
layer: layer 
indirection: indirection 
owner: owner 
initfp: initfp 
ssnd: ssnd 
alan: alan 
moore: moore 
primarily: primarily 
notification: notification 
erver: erver 
cope: cope 
scopeid: scopeid 
recvfrom: recvfrom 
multicast: multicast 
packet: packet 
resolving: resolving 
unhexlify: unhexlify 
recurses: recurses 
qipcrtr: qipcrtr 
gps: gps 
radio: radio 
qualcomm: qualcomm 
bjorn: bjorn 
andersson: andersson 
successful: successful 
backup: backup 
lele: lele 
gaifax: gaifax 
segev: segev 
finer: finer 
hangul: hangul 
sentinel: sentinel 
conf: conf 
elaborated: elaborated 
ric: ric 
araujo: araujo 
unexisting: unexisting 
xyz: xyz 
appropriated: appropriated 
chm: chm 
charaters: charaters 
mbcs: mbcs 
georg: georg 
brandl: brandl 
sense: sense 
stdtypes: stdtypes 
concerning: concerning 
membership: membership 
migrate: migrate 
hoffmann: hoffmann 
wrongly: wrongly 
chapter: chapter 
pythonutf: pythonutf 
versionadded: versionadded 
lot: lot lots 
typedef: typedef 
getargspec: getargspec 
respective: respective 
pypi: pypi 
asynccontextmanager: asynccontextmanager 
korean: korean 
tocontiguous: tocontiguous 
islice: islice 
zipapp: zipapp 
describe: describe 
jon: jon 
foster: foster 
berker: berker 
peksag: peksag 
windowsregistryfinder: windowsregistryfinder 
metapathfinder: metapathfinder 
himanshu: himanshu 
lakhara: lakhara 
emphasized: emphasized 
oo: oo 
terry: terry 
reedy: reedy 
philip: philip 
gehrcke: gehrcke 
externalized: externalized 
sparse: sparse 
ppc: ppc 
tmpfs: tmpfs 
hole: holes hole 
effective: effective 
aarch: aarch 
punch: punch 
unbreaks: unbreaks 
teardownmodule: teardownmodule 
sigalrm: sigalrm 
testdidnotrun: testdidnotrun 
demonstrating: demonstrating 
patching: patching 
daylight: daylight 
dst: dst 
shipped: shipped 
docstest: docstest 
enforced: enforced 
antony: antony 
rdstest: rdstest 
testcongestion: testcongestion 
receiver: receiver 
rds: rds 
producer: producer 
design: design designs 
unzip: unzip 
flakiness: flakiness 
scary: scary 
rsa: rsa 
sockname: sockname 
pton: pton 
getcpuclickid: getcpuclickid 
cpp: cpp 
huntrleaks: huntrleaks 
fallocate: fallocate 
zfs: zfs 
mcet: mcet 
fcf: fcf 
protection: protection 
smtputf: smtputf 
simtests: simtests 
bitfields: bitfields 
ibm: ibm 
secp: secp 
ecdh: ecdh 
curve: curves curve 
step: step steps 
verifying: verifying 
asynciomodule: asynciomodule 
pythoncore: pythoncore 
vcxproj: vcxproj 
ifdef: ifdef 
svr: svr 
linker: linker 
pyexpat: pyexpat 
inlinefunctionexpansion: inlinefunctionexpansion 
onlyexplicitinline: onlyexplicitinline 
pyproject: pyproject 
little: little 
pyexpatns: pyexpatns 
embedding: embedding 
outdated: outdated 
sh: sh 
revision: revision 
automake: automake 
pedantic: pedantic 
junit: junit 
devops: devops 
sockaddr: sockaddr 
pythread: pythread 
necessity: necessity 
latter: latter 
updating: updating 
wstrict: wstrict 
prototype: prototypes 
regenerated: regenerated 
team: team 
triplet: triplets triplet 
mips: mips 
riscv: riscv 
dpy: dpy 
preprocessor: preprocessor 
heuristic: heuristic heuristics 
stock: stock 
seems: seems 
hit: hit 
noargs: noargs 
optparse: optparse 
getversionex: getversionex 
wcstok: wcstok 
envbuilder: envbuilder 
launching: launching 
unchecked: unchecked 
embeddable: embeddable 
redirector: redirector 
findvs: findvs 
vswhere: vswhere 
pyshellext: pyshellext 
structs: structs 
socketmodule: socketmodule 
dlls: dlls 
whenever: whenever 
interact: interact 
badly: badly 
dpi: dpi 
inputhook: inputhook 
integration: integration integrations 
gui: gui 
matplotlib: matplotlib 
figure: figures 
readconsole: readconsole 
canceled: canceled 
cancelsynchronousio: cancelsynchronousio 
getlasterror: getlasterror 
execve: execve 
unc: unc 
windowsconsoleio: windowsconsoleio 
denormalized: denormalized 
ipconfig: ipconfig 
printnameoffset: printnameoffset 
craig: craig 
holmquist: holmquist 
summaryinfo: summaryinfo 
al: al 
recursivewildcardselector: recursivewildcardselector 
iterate: iterate 
editrc: editrc 
processed: processed 
editline: editline 
emulation: emulation 
activetcl: activetcl 
scproxy: scproxy 
systemconfiguration: systemconfiguration 
macosx: macosx 
untitled: untitled 
proper: proper 
smart: smart 
squeezer: squeezer 
gray: gray 
dock: dock 
indefinitely: indefinitely 
overfill: overfill 
console: console 
implication: implications 
stdxxx: stdxxx 
viewer: viewer 
backporting: backporting 
hg: hg 
elimination: elimination 
squeezing: squeezing 
losing: losing 
squeezed: squeezed 
viewed: viewed 
unsqueezed: unsqueezed 
direction: direction 
calltips: calltips 
idletasks: idletasks 
unresponsiveness: unresponsiveness 
htests: htests 
stackview: stackview 
stackbrowser: stackbrowser 
mainmenu: mainmenu 
menudefs: menudefs 
menudef: menudef 
template: templates template 
revised: revised 
readme: readme 
explains: explains 
rstripextension: rstripextension 
calltipwindow: calltipwindow 
welcome: welcome 
minimally: minimally 
instantiate: instantiate 
saying: saying 
monitor: monitor 
sharper: sharper 
scroll: scroll 
mouse: mouse 
scrollbar: scrollbar 
slider: slider 
maxlines: maxlines 
codecontext: codecontext 
click: click clicks 
movement: movement 
backspace: backspace 
paired: paired 
presenting: presenting 
idlestartup: idlestartup 
unsets: unsets 
stringtranslatepseudomapping: stringtranslatepseudomapping 
dependent: dependent 
idea: idea 
decodes: decodes 
far: far 
ahead: ahead 
credit: credits 
bitwise: bitwise 
pygettext: pygettext 
translatable: translatable 
oleg: oleg 
krasnikov: krasnikov 
pystackv: pystackv 
pystack: pystack 
gdbinit: gdbinit 
extracting: extracting 
toby: toby 
harradine: harradine 
pybytearray: pybytearray 
resize: resize 
encodefsdefault: encodefsdefault 
incref: incref 
xdecref: xdecref 
surrounded: surrounded 
conditionally: conditionally 
finalizeex: finalizeex 
arthur: arthur 
neufeld: neufeld 
setprogramfullpath: setprogramfullpath 
embedders: embedders 
legacywindowsfsencodingflag: legacywindowsfsencodingflag 
pluralization: pluralization 
getargs: getargs 
typeobject: typeobject 
grammatically: grammatically 
parsetupleandkeywords: parsetupleandkeywords 
pycompile: pycompile 
opcodestackeffectwithjump: opcodestackeffectwithjump 
pysequence: pysequence 
delitem: delitem 
resetwarnoptions: resetwarnoptions 
addwarnoption: addwarnoption 
phase: phase 
sanity: sanity 
aswidechar: aswidechar 
aswidecharstring: aswidecharstring 
wno: wno 
debugger: debuggers debugger 
suggestion: suggestions suggestion 
compound: compound 
semi: semi 
nitish: nitish 
chandra: chandra 
lexical: lexical 
isascii: isascii 
enforce: enforce 
coroutinetype: coroutinetype 
getattribute: getattribute 
faced: faced 
datasets: datasets 
rc: rc 
estimation: estimation 
similarly: similarly 
north: north 
rid: rid 
exposing: exposing 
blacklist: blacklist 
approach: approach 
coded: coded 
contextmanager: contextmanager 
martin: martin 
teichmann: teichmann 
fionread: fionread 
fionclex: fionclex 
fioclex: fioclex 
fioasync: fioasync 
fionbio: fionbio 
derivative: derivatives 
username: username 
xiang: xiang 
fstype: fstype 
serving: serving 
crlf: crlf 
hardware: hardware 
turned: turned 
cancelation: cancelation 
melero: melero 
ni: nis 
libnsl: libnsl 
valuesview: valuesview 
abcmeta: abcmeta 
rpc: rpc 
replacement: replacements replacement 
libtirpc: libtirpc 
graceful: graceful 
presumed: presumed 
gotten: gotten 
continuing: continuing 
sigkill: sigkill 
auto: auto 
getblocking: getblocking 
unified: unified 
wishing: wishing 
resourceloader: resourceloader 
alexander: alexander 
mohr: mohr 
ilya: ilya 
kulakov: kulakov 
sep: sep 
subject: subject 
real: real 
internationalized: internationalized 
landed: landed 
thorough: thorough 
ecdsa: ecdsa 
ec: ec 
libxcrypt: libxcrypt 
libcrypt: libcrypt 
autoconf: autoconf 
ax: ax 
uninstall: uninstall 
re: res 
timzone: timzone 
utc: utc 
fsid: fsid 
statvfs: statvfs 
turn: turn turns 
pythonhashseed: pythonhashseed 
spending: spending 
calculation: calculation calculations 
consuming: consuming 
increased: increased 
versionhelpers: versionhelpers 
tracebacktype: tracebacktype 
tb: tbs tb 
mutable: mutable 
endian: endian 
bb: bb 
inject: inject 
byteswarning: byteswarning 
precedence: precedence 
pythonwarnings: pythonwarnings 
injects: injects 
behaves: behaves 
identically: identically 
wdefault: wdefault 
ivan: ivan 
levkivskyi: levkivskyi 
invalidating: invalidating 
bashed: bashed 
eugene: eugene 
toder: toder 
keeping: keeping 
happening: happening 
notimplementederror: notimplementederror 
iscoroutine: iscoroutine 
boost: boost 
settimeout: settimeout 
setblocking: setblocking 
nonblock: nonblock 
cloexec: cloexec 
sendall: sendall 
getnameinfo: getnameinfo 
listening: listening 
abort: abort aborts 
misunderstanding: misunderstanding 
pyatexit: pyatexit 
fpectl: fpectl 
worked: worked 
classified: classified 
classify: classify 
grouped: grouped 
ouput: ouput 
classmethoddescriptortype: classmethoddescriptortype 
synchronization: synchronization 
primitive: primitives 
styled: styled 
registering: registering 
isoformat: isoformat 
getter: getter 
serializing: serializing 
subtraction: subtraction 
abstractasynccontextmanager: abstractasynccontextmanager 
jelle: jelle 
zijlstra: zijlstra 
eventually: eventually 
reconfigure: reconfigure 
abstractserver: abstractserver 
getrlimit: getrlimit 
readily: readily 
probing: probing 
pygetopt: pygetopt 
nofree: nofree 
freevars: freevars 
cellvars: cellvars 
needing: needing 
injected: injected 
enclosing: enclosing 
deeply: deeply 
rawmalloc: rawmalloc 
setlocalefromenv: setlocalefromenv 
pytraceback: pytraceback 
tracebacklimit: tracebacklimit 
suppresses: suppresses 
looping: looping 
endlessly: endlessly 
partition: partition 
rpartition: rpartition 
fromlist: fromlist 
lexically: lexically 
therefore: therefore 
zane: zane 
bitter: bitter 
rounding: rounding 
freed: freed 
shrinking: shrinking 
printex: printex 
setobjectid: setobjectid 
boilerplate: boilerplate 
fileio: fileio 
readall: readall 
nfs: nfs 
socketpair: socketpair 
pydebug: pydebug 
preferentially: preferentially 
universally: universally 
administered: administered 
locally: locally 
uniqueness: uniqueness 
uuids: uuids 
mandeep: mandeep 
singh: singh 
vt: vt 
mc: mc 
mahon: mahon 
netrc: netrc 
dimitri: dimitri 
merejkowsky: merejkowsky 
oldest: oldest 
ab: abs 
jesse: jesse 
bakker: bakker 
robin: robin 
wellner: wellner 
ter: ter 
warns: warns 
classifier: classifiers 
nullcontext: nullcontext 
enforcing: enforcing 
importwarning: importwarning 
searching: searching 
splitting: splitting 
plists: plists 
bytearrays: bytearrays 
identical: identical 
memorybio: memorybio 
anyway: anyway 
iscallable: iscallable 
decrease: decrease 
unpickled: unpickled 
incompletereaderror: incompletereaderror 
limitoverrunerror: limitoverrunerror 
reconnection: reconnection 
flushing: flushing 
formally: formally 
bc: bc 
ba: ba 
bd: bd 
untested: untested 
configurable: configurable 
blocksize: blocksize 
onnection: onnection 
throughput: throughput 
marat: marat 
sharafutdinov: sharafutdinov 
determining: determining 
ifconfig: ifconfig 
arp: arp 
takayuki: takayuki 
shimizukawa: shimizukawa 
leaf: leaf leaves 
jack: jack 
connor: connor 
poolexecutor: poolexecutor 
dragonfly: dragonfly 
corruption: corruption 
ungetmouse: ungetmouse 
chtype: chtype 
mmask: mmask 
fink: fink 
boottime: boottime 
prof: prof 
invalidfileexception: invalidfileexception 
masayuki: masayuki 
yamamoto: yamamoto 
kqueue: kqueue 
gollahon: gollahon 
mksalt: mksalt 
behaved: behaved 
timed: timed 
intr: intr 
recompute: recompute 
ssse: ssse 
itermonthdates: itermonthdates 
tolerate: tolerate 
itermonthdays: itermonthdays 
persistent: persistent 
unpickler: unpickler 
subnet: subnet 
superset: superset 
containment: containment 
michel: michel 
albert: albert 
clegg: clegg 
adapter: adapters 
loggeradapter: loggeradapter 
settable: settable 
microsecond: microsecond microseconds 
seal: seal 
settime: settime 
pollers: pollers 
futurewarning: futurewarning 
semantically: semantically 
blowfish: blowfish 
sslprotocoltransport: sslprotocoltransport 
getkey: getkey 
vincent: vincent 
riccardo: riccardo 
coccioli: coccioli 
launched: launched 
immune: immune 
misdirected: misdirected 
vitor: vitor 
pereira: pereira 
baseeventloop: baseeventloop 
ervers: ervers 
apfs: apfs 
enokey: enokey 
directorytestcase: directorytestcase 
commit: commit 
ndk: ndk 
sysroot: sysroot 
stamp: stamp 
atheos: atheos 
fetch: fetch 
msierror: msierror 
tuininga: tuininga 
apps: apps 
stackcheck: stackcheck 
driven: driven 
distracting: distracting 
tabbedpages: tabbedpages 
tabbedpageset: tabbedpageset 
notebook: notebook 
pathbrowser: pathbrowser 
simplifies: simplifies 
inserted: inserted 
editable: editable 
persist: persist 
ditto: ditto 
selects: selects 
subset: subset 
multilingual: multilingual 
plane: plane 
arranged: arranged 
cv: cvs 
subversion: subversion 
svneol: svneol 
treesync: treesync 
migrated: migrated 
develop: develop 
redemo: redemo 
sarnowski: sarnowski 
useclassexceptionsflag: useclassexceptionsflag 
routine: routine 
couple: couple 
obscure: obscure 
pyexc: pyexc 
recursionerrorinst: recursionerrorinst 
permanent: permanent 
effectively: effectively 
stability: stability 
aiter: aiter 
underscore: underscores underscore 
decompress: decompress 
instrumented: instrumented 
probe: probes 
reducing: reducing 
importtime: importtime 
pythonprofileimporttime: pythonprofileimporttime 
breakpointhook: breakpointhook 
armin: armin 
rigo: rigo 
splitlines: splitlines 
idpattern: idpattern 
matched: matched 
regexflag: regexflag 
bm: bm 
adderrorinfo: adderrorinfo 
predicate: predicates predicate 
compressed: compressed 
dumped: dumped 
getcpuclockid: getcpuclockid 
concurrently: concurrently 
groupby: groupby 
advancing: advancing 
thus: thus 
repeat: repeats repeat 
insteads: insteads 
bootstrapping: bootstrapping 
smith: smith 
ranlib: ranlib 
substitution: substitution 
wholesale: wholesale 
rebuild: rebuild 
flist: flist 
browsing: browsing 
htest: htest 
utest: utest 
dependence: dependence 
ago: ago 
yesterday: yesterday 
scaled: scaled 
hidpi: hidpi 
guilherme: guilherme 
polo: polo 
storage: storage 
tss: tss 
supersede: supersede 
deprecating: deprecating 
erik: erik 
bray: bray 
bio: bio 
fuzz: fuzz 
flooding: flooding 
entropy: entropy 
getrandom: getrandom 
secret: secret secrets 
sethashsalt: sethashsalt 
splithost: splithost 
evil: evil 
login: login 
defaultaction: defaultaction 
getmoduledict: getmoduledict 
uniformity: uniformity 
complication: complications 
bunch: bunch 
onceregistry: onceregistry 
emission: emission 
demotion: demotions 
flake: flake 
consolidate: consolidate 
discoverability: discoverability 
prepend: prepend 
sysmacros: sysmacros 
makedev: makedev 
libray: libray 
plan: plans 
masking: masking 
concurrency: concurrency 
sensitive: sensitive 
unloaded: unloaded 
reimports: reimports 
delivery: delivery 
upgraded: upgraded 
freefuncs: freefuncs 
optimal: optimal 
suitable: suitable 
aware: aware 
nl: nl 
backslashes: backslashes 
inserting: inserting 
duane: duane 
griffin: griffin 
mitchell: mitchell 
delattr: delattr 
middle: middle 
resuming: resuming 
delivered: delivered 
innermost: innermost 
getsizeof: getsizeof 
readmes: readmes 
shift: shift 
opportunity: opportunity 
slowing: slowing 
unlucky: unlucky 
oversight: oversight 
inadvertently: inadvertently 
percent: percents percent 
classic: classic 
anext: anext 
setextra: setextra 
brian: brian 
coleman: coleman 
segv: segv 
matthieu: matthieu 
dartiailh: dartiailh 
dereferencing: dereferencing 
stmt: stmt 
firstlineno: firstlineno 
mircea: mircea 
cosbuc: cosbuc 
runmainfromimporter: runmainfromimporter 
overwriting: overwriting 
fromhex: fromhex 
xiao: xiao 
positioning: positioning 
layzell: layzell 
octals: octals 
chi: chi 
fsencode: fsencode 
fsdecode: fsdecode 
susceptible: susceptible 
reentrancy: reentrancy 
triggerable: triggerable 
monkey: monkey 
combined: combined 
syntaxlocationex: syntaxlocationex 
syntaxlocationobject: syntaxlocationobject 
xxlimited: xxlimited 
getcallstats: getcallstats 
wordcode: wordcode 
encoders: encoders 
ff: ff 
newpresized: newpresized 
ellington: ellington 
ioctl: ioctl 
langinfo: langinfo 
astral: astral 
pythonpath: pythonpath 
adrian: adrian 
wielgosik: wielgosik 
setdefault: setdefault 
eric: eric 
asdecodedobject: asdecodedobject 
problematic: problematic 
copycharacters: copycharacters 
koep: koep 
soumya: soumya 
sharma: sharma 
unscathed: unscathed 
looked: looked 
eperm: eperm 
seccomp: seccomp 
rshift: rshift 
memcpy: memcpy 
splitted: splitted 
globalns: globalns 
mitar: mitar 
storing: storing 
daemonic: daemonic 
substantially: substantially 
precomputed: precomputed 
benefit: benefits 
approx: approx 
measured: measured 
ups: ups 
primary: primary 
contributor: contributor 
raymond: raymond 
hettinger: hettinger 
customizable: customizable 
instantiated: instantiated 
sslcertverificationerror: sslcertverificationerror 
costly: costly 
intermixed: intermixed 
intermixes: intermixes 
micro: micro 
braceidpattern: braceidpattern 
placeholder: placeholder 
vsock: vsock 
communication: communication 
workitem: workitem 
james: james 
tocknell: tocknell 
serverthread: serverthread 
docserver: docserver 
quit: quit 
informative: informative 
noconf: noconf 
research: research 
gustavo: gustavo 
serra: serra 
scalet: scalet 
joined: joined 
collins: collins 
diagnosis: diagnosis 
luciano: luciano 
ramalho: ramalho 
uninformative: uninformative 
allen: allen 
drallensmith: drallensmith 
github: github 
zombie: zombie 
destroy: destroy 
labeledscale: labeledscale 
slotnames: slotnames 
mangled: mangled 
shane: shane 
harvey: harvey 
setstream: setstream 
streamhandler: streamhandler 
oids: oids 
christian: christian 
heimes: heimes 
mmaps: mmaps 
careful: careful 
gallagher: gallagher 
decrementing: decrementing 
sharedctypes: sharedctypes 
typecodes: typecodes 
radiobuttons: radiobuttons 
econnreset: econnreset 
cfuture: cfuture 
setitimer: setitimer 
tiny: tiny 
taking: taking 
scheduling: scheduling 
notify: notify 
claim: claims claim 
lacked: lacked 
sleeper: sleepers 
wake: wake 
white: white 
fips: fips 
putline: putline 
subtest: subtest 
lgettext: lgettext 
nathaniel: nathaniel 
opposite: opposite 
alexandru: alexandru 
ardelean: ardelean 
disassemble: disassemble 
succeeded: succeeded 
took: took 
misplaced: misplaced 
roy: roy 
williams: williams 
micha: micha 
sgha: sgha 
er: er 
nikolay: nikolay 
waiter: waiters waiter 
mathieu: mathieu 
sornay: sornay 
addded: addded 
subclassers: subclassers 
deny: deny 
organize: organize 
pack: pack 
yuan: yuan 
liu: liu 
sysloghandler: sysloghandler 
mariatta: mariatta 
wijaya: wijaya 
hz: hz 
partialmethod: partialmethod 
inners: inners 
conditionals: conditionals 
wsaeinval: wsaeinval 
shut: shut 
rdwr: rdwr 
attempted: attempted 
internaldict: internaldict 
readplist: readplist 
readplistfrombytes: readplistfrombytes 
abstractcontextmanager: abstractcontextmanager 
anti: anti 
weaken: weaken 
subsequential: subsequential 
quentel: quentel 
scanner: scanner 
misusing: misusing 
wrapperdescriptortype: wrapperdescriptortype 
jim: jim 
fasarakis: fasarakis 
hilliard: hilliard 
assertalmostequal: assertalmostequal 
assertnotalmostequal: assertnotalmostequal 
italic: italic 
isabstract: isabstract 
nate: nate 
soares: soares 
bryan: bryan 
olson: olson 
readlines: readlines 
sizeable: sizeable 
mkdir: mkdir 
unchaining: unchaining 
siddharth: siddharth 
velankar: velankar 
schema: schema 
ieee: ieee 
sanjay: sanjay 
sundaresan: sundaresan 
correspondingly: correspondingly 
swallow: swallows swallow 
davin: davin 
potts: potts 
eacces: eacces 
eexist: eexist 
finished: finished 
makedirs: makedirs 
intermediate: intermediate 
sigaltstack: sigaltstack 
teardown: teardown 
christophe: christophe 
zeitouny: zeitouny 
seifert: seifert 
erf: erf 
erfc: erfc 
inode: inode 
ino: ino 
intables: intables 
notsent: notsent 
lowat: lowat 
elli: ellis 
subprocessstreamprotocol: subprocessstreamprotocol 
simplexmlrpcdispatcher: simplexmlrpcdispatcher 
dispatched: dispatched 
motejlek: motejlek 
sayan: sayan 
chowdhury: chowdhury 
transaction: transaction 
theune: theune 
ratnadeep: ratnadeep 
debnath: debnath 
altering: altering 
kwarg: kwarg 
aiff: aiff 
safeuuid: safeuuid 
relay: relay 
deprecationwarnings: deprecationwarnings 
pydecimal: pydecimal 
manuel: manuel 
krebber: krebber 
ukasz: ukasz 
langa: langa 
wgh: wgh 
methoddescriptortype: methoddescriptortype 
vander: vander 
weele: weele 
unpickle: unpickle 
exited: exited 
ptrace: ptrace 
magickmock: magickmock 
splitunc: splitunc 
cdll: cdll 
uncached: uncached 
milan: milan 
oberkirch: oberkirch 
jiajun: jiajun 
huang: huang 
getframeinfo: getframeinfo 
sam: sam 
breese: breese 
dingyuan: dingyuan 
resized: resized 
textpad: textpad 
textbox: textbox 
tycho: tycho 
andersen: andersen 
tix: tix 
deallocate: deallocate 
prlimit: prlimit 
preload: preload 
preloaded: preloaded 
recreated: recreated 
letter: letter 
showwarning: showwarning 
assist: assist 
getfullargspec: getfullargspec 
decision: decision 
revisited: revisited 
getandroidapilevel: getandroidapilevel 
congestion: congestion 
omar: omar 
sandoval: sandoval 
sre: sre 
comparable: comparable 
reloaded: reloaded 
endtime: endtime 
vajrasky: vajrasky 
kok: kok 
deallocator: deallocator 
sebastian: sebastian 
cufre: cufre 
fogle: fogle 
firefox: firefox 
broytman: broytman 
steele: steele 
representing: representing 
intvar: intvar 
textcalendar: textcalendar 
prweek: prweek 
pryear: pryear 
prmonth: prmonth 
month: months month 
textwrap: textwrap 
textwrapper: textwrapper 
kaarle: kaarle 
ritvanen: ritvanen 
val: val 
hlist: hlist 
addin: addin 
silentghost: silentghost 
timeit: timeit 
autoranging: autoranging 
bufferediobase: bufferediobase 
multithreading: multithreading 
autorange: autorange 
sdist: sdist 
chrome: chrome 
ned: ned 
batchelder: batchelder 
disassembler: disassembler 
truncation: truncations 
htons: htons 
ntohs: ntohs 
leitch: leitch 
imghdr: imghdr 
gmtime: gmtime 
schouten: schouten 
extreme: extreme 
reimplemented: reimplemented 
lzmadecompressor: lzmadecompressor 
collation: collation 
macholib: macholib 
madison: madison 
displaystyle: displaystyle 
falsy: falsy 
bytestring: bytestring 
antigravity: antigravity 
kaartic: kaartic 
sivaraam: sivaraam 
urljoin: urljoin 
gergely: gergely 
imreh: imreh 
markus: markus 
holtermann: holtermann 
envlist: envlist 
qp: qp 
traffic: traffic 
conway: conway 
reuseport: reuseport 
seth: seth 
larson: larson 
iceboy: iceboy 
selectorloop: selectorloop 
vestigial: vestigial 
macurl: macurl 
refuse: refuse 
monitoring: monitoring 
readexactly: readexactly 
florian: florian 
ch: ch 
getrecursionlimit: getrecursionlimit 
pietri: pietri 
snippet: snippet 
zeromqsocketlistener: zeromqsocketlistener 
zeromqsockethandler: zeromqsockethandler 
mozilla: mozilla 
truth: truth 
thomassen: thomassen 
daily: daily 
emphasizing: emphasizing 
utility: utility 
internationalization: internationalization 
constraint: constraints constraint 
aiosmtpd: aiosmtpd 
canonical: canonical 
porting: porting 
guide: guides guide 
localhost: localhost 
hostv: hostv 
alpn: alpn 
tzdata: tzdata 
extralargefile: extralargefile 
nomemory: nomemory 
mem: mem 
grzegorz: grzegorz 
grzywacz: grzywacz 
testembed: testembed 
getservbyname: getservbyname 
getservbyport: getservbyport 
unwritable: unwritable 
unreadable: unreadable 
entirely: entirely 
testconsole: testconsole 
armv: armv 
qemu: qemu 
emulator: emulator 
century: century 
difficult: difficult 
irix: irix 
vcvarsall: vcvarsall 
listed: listed 
neither: neither 
rebuilding: rebuilding 
touch: touch 
werror: werror 
setmode: setmode 
petazzoni: petazzoni 
multiarch: multiarch 
tristan: tristan 
carel: carel 
haubenwallner: haubenwallner 
optimiations: optimiations 
pyvarobject: pyvarobject 
roumen: roumen 
petrov: petrov 
tishler: tishler 
siginfo: siginfo 
review: review 
rebase: rebase 
estonian: estonian 
distclean: distclean 
arfrever: arfrever 
frehtes: frehtes 
taifersar: taifersar 
arahesis: arahesis 
getentropy: getentropy 
gareth: gareth 
rees: rees 
logical: logical 
xmlns: xmlns 
gadget: gadget 
barnes: barnes 
pulling: pulling 
mishandled: mishandled 
reallocation: reallocation 
getpathp: getpathp 
catalog: catalog 
osfhandle: osfhandle 
renames: renames 
applying: applying 
parenmatch: parenmatch 
zzdummy: zzdummy 
experimentation: experimentation 
rearrange: rearrange 
genpage: genpage 
outwin: outwin 
supposedly: supposedly 
worse: worse 
maintenance: maintenance 
uniformly: uniformly 
editing: editing 
keyset: keyset 
together: together 
keysets: keysets 
flash: flash 
paren: paren 
customizations: customizations 
customization: customization 
charles: charles 
wohlganger: wohlganger 
highpage: highpage 
keyspage: keyspage 
outline: outline 
tabpage: tabpage 
fontpage: fontpage 
rearranging: rearranging 
pertaining: pertaining 
aid: aid 
vartrace: vartrace 
tracer: tracers 
manages: manages 
causal: causal 
pathway: pathways 
colour: colour 
idleconf: idleconf 
taken: taken 
facilitate: facilitate 
getusercfgdir: getusercfgdir 
configchanges: configchanges 
changestest: changestest 
partly: partly 
textview: textview 
parens: parens 
synonym: synonym 
saimadhav: saimadhav 
heblikar: heblikar 
commenting: commenting 
overly: overly 
cryptic: cryptic 
autocompletion: autocompletion 
hitting: hitting 
subsubsection: subsubsection 
directs: directs 
ur: ur 
augment: augment 
evalframedefault: evalframedefault 
inlines: inlines 
evalframeex: evalframeex 
broke: broke 
polaco: polaco 
penteado: penteado 
semantical: semantical 
booleans: booleans 
repeating: repeating 
wrapperobject: wrapperobject 
pybench: pybench 
pystone: pystone 
microbenchmark: microbenchmark 
stephen: stephen 
turnbull: turnbull 
pthreads: pthreads 
unconditional: unconditional 
beforefork: beforefork 
setasyncexc: setasyncexc 
pyslice: pyslice 
getindicesex: getindicesex 
adjustindices: adjustindices 
vaparse: vaparse 
vaparsetupleandkeywords: vaparsetupleandkeywords 
validatekeywordarguments: validatekeywordarguments 
unpacktuple: unpacktuple 
findchar: findchar 
comparewithasciistring: comparewithasciistring 
pygetsetdef: pygetsetdef 
desc: desc 
wrapperbase: wrapperbase 
packagecontext: packagecontext 
asencodedobject: asencodedobject 
asdecodedunicode: asdecodedunicode 
asencodedunicode: asencodedunicode 
strerror: strerror 
debian: debian 
sslv: sslv 
xz: xz 
soft: soft 
uploadrelease: uploadrelease 
spewing: spewing 
omission: omission 
separately: separately 
extern: extern 
quality: quality 
randomness: randomness 
randbelow: randbelow 
brendan: brendan 
donegan: donegan 
andra: andra 
bogildea: bogildea 
neaten: neaten 
population: population 
upstream: upstream 
asyncore: asyncore 
hoho: hoho 
ho: ho 
fastcalls: fastcalls 
redefinition: redefinition 
agreed: agreed 
isfuture: isfuture 
isawaitable: isawaitable 
mayfield: mayfield 
asyncgenerator: asyncgenerator 
gen: gen gens 
johannes: johannes 
ebke: ebke 
han: hans 
lawrenz: lawrenz 
defer: defer 
corrupted: corrupted 
fromlong: fromlong 
chris: chris 
angelico: angelico 
fried: fried 
enclosed: enclosed 
hi: hi 
differencing: differencing 
rework: rework 
shorter: shorter 
demur: demur 
rumed: rumed 
reviewed: reviewed 
emanuel: emanuel 
pypy: pypy 
concept: concept 
developed: developed 
inttypes: inttypes 
stdint: stdint 
basically: basically 
formality: formality 
ce: ce 
estimate: estimate 
invert: invert 
longs: longs 
analysis: analysis 
backreference: backreference 
pvs: pvs 
unreliable: unreliable 
ldexp: ldexp 
brand: brand 
codeobject: codeobject 
spawnv: spawnv 
autocommit: autocommit 
intransaction: intransaction 
tm: tm 
gmtoff: gmtoff 
ddl: ddl 
unmarshalling: unmarshalling 
apache: apache 
numerics: numerics 
resumption: resumption 
certfile: certfile 
unusual: unusual 
readrc: readrc 
matusiak: matusiak 
kimbrel: kimbrel 
generalization: generalizations 
mailcap: mailcap 
intflag: intflag 
intenum: intenum 
intflags: intflags 
validates: validates 
now: nows 
approved: approved 
cte: cte 
decodedgenerator: decodedgenerator 
plat: plat 
cdrom: cdrom 
dlfcn: dlfcn 
cdio: cdio 
stropts: stropts 
mimetext: mimetext 
payload: payload payloads 
claude: claude 
paroz: paroz 
reorganized: reorganized 
emphasize: emphasize 
predictable: predictable 
importerrors: importerrors 
attachment: attachment attachments 
mutation: mutation 
tautological: tautological 
globbing: globbing 
scrypt: scrypt 
derivation: derivation 
sweet: sweet 
chacha: chacha 
poly: poly 
winsound: winsound 
messagebeep: messagebeep 
snd: snd 
playsound: playsound 
lesher: lesher 
eli: eli 
stevens: stevens 
inf: inf 
nan: nan nans 
infj: infj 
nanj: nanj 
holden: holden 
isolation: isolation 
seeding: seeding 
obtained: obtained 
nofar: nofar 
schnider: schnider 
chunked: chunked 
unnormalised: unnormalised 
exponent: exponent 
ctes: ctes 
sdists: sdists 
gztar: gztar 
gzipped: gzipped 
ld: ld 
andrade: andrade 
nesting: nesting 
wojciech: wojciech 
walczak: walczak 
serwy: serwy 
bayard: bayard 
randel: randel 
flashing: flashing 
classroom: classroom 
projection: projection 
selected: selected 
underscored: underscored 
fsconverter: fsconverter 
fsdecoder: fsdecoder 
couzo: couzo 
poor: poor 
tan: tan 
rigour: rigour 
jeff: jeff 
ucrtbase: ucrtbase 
systemtap: systemtap 
libpl: libpl 
certifi: certifi 
fixcid: fixcid 
targetdir: targetdir 
oem: oem 
aliasmbcs: aliasmbcs 
cherry: cherry 
abbreviated: abbreviated 
decreased: decreased 
wincrypt: wincrypt 
gw: gw 
privately: privately 
unabling: unabling 
neil: neil 
girdhar: girdhar 
existed: existed 
barnert: barnert 
mathematical: mathematical 
tau: tau 
stacksummary: stacksummary 
abbreviates: abbreviates 
harmonic: harmonic 
descriptortypes: descriptortypes 
getstr: getstr 
instr: instr 
methodcaller: methodcaller 
unowned: unowned 
xy: xy 
chuck: chuck 
compressing: compressing 
disambiguation: disambiguation 
epollexclusive: epollexclusive 
epollrdhup: epollrdhup 
pollrdhup: pollrdhup 
negation: negation 
alexandre: alexandre 
vassalotti: vassalotti 
unintentional: unintentional 
feedparser: feedparser 
messagebox: messagebox 
redo: redo 
refinement: refinements 
roseman: roseman 
confighandler: confighandler 
drag: drag 
exp: exp 
cppflags: cppflags 
freedbsd: freedbsd 
alloc: alloc 
showalloccount: showalloccount 
lev: lev 
maximov: maximov 
unclean: unclean 
netscape: netscape 
confirming: confirming 
differs: differs 
streamrequesthandler: streamrequesthandler 
wfile: wfile 
vdelete: vdelete 
vinfo: vinfo 
jsonencoder: jsonencoder 
jsondecoder: jsondecoder 
isblank: isblank 
iscntrl: iscntrl 
ispunct: ispunct 
sio: sio 
stokes: stokes 
excepts: excepts 
managed: managed 
lastrowid: lastrowid 
alex: alex 
lordthorsen: lordthorsen 
pager: pager pagers 
manpager: manpager 
begidx: begidx 
endidx: endidx 
fulton: fulton 
sectionname: sectionname 
modulename: modulename 
helpsource: helpsource 
itw: itw 
validity: validity 
cleanly: cleanly 
cascade: cascade 
mainloop: mainloop 
machdep: machdep 
ldversion: ldversion 
sysconfigdata: sysconfigdata 
abiflags: abiflags 
largefile: largefile 
hurd: hurd 
importbench: importbench 
sidebar: sidebar 
footer: footer 
term: term 
piercy: piercy 
notsupportederror: notsupportederror 
dave: dave 
sawyer: sawyer 
generalized: generalized 
bracket: brackets 
shlock: shlock 
exlock: exlock 
meaningful: meaningful 
recognizable: recognizable 
oststrom: oststrom 
bae: bae 
luethi: luethi 
ingrid: ingrid 
dusty: dusty 
phillips: phillips 
overload: overload 
numerous: numerous 
mypy: mypy 
analyzer: analyzers 
asynciterable: asynciterable 
asynciterator: asynciterator 
mentioned: mentioned 
susumu: susumu 
koshiba: koshiba 
grnd: grnd 
colm: colm 
buckley: buckley 
jacek: jacek 
ko: ko 
odziej: odziej 
deflate: deflate 
predefined: predefined 
zdict: zdict 
wsgirequesthandler: wsgirequesthandler 
serverhandler: serverhandler 
dy: dies 
circumstance: circumstances 
flipping: flipping 
sigiot: sigiot 
calledprocesserror: calledprocesserror 
died: died 
rror: rror 
validator: validator 
filterwarnings: filterwarnings 
simplefilter: simplefilter 
shkop: shkop 
queryvalueex: queryvalueex 
qword: qword 
deserialize: deserialize 
scrollbars: scrollbars 
isxyztk: isxyztk 
aqua: aqua 
unbinding: unbinding 
themechanged: themechanged 
persisted: persisted 
suppressed: suppressed 
configuring: configuring 
referred: referred 
percolator: percolator 
westley: westley 
mart: mart 
nez: nez 
undo: undo 
delegator: delegator 
pythondocs: pythondocs 
sean: sean 
rodman: rodman 
kaushik: kaushik 
nadikuditi: nadikuditi 
yoni: yoni 
lavi: lavi 
buildbot: buildbot 
interactively: interactively 
xavier: xavier 
gaye: gaye 
joe: joe 
jevnik: jevnik 
rawconfigparser: rawconfigparser 
pypirc: pypirc 
interpolation: interpolation 
unintentionally: unintentionally 
endorsed: endorsed 
filefinder: filefinder 
exhausting: exhausting 
snider: snider 
reloading: reloading 
pythonmallocstats: pythonmallocstats 
sensible: sensible 
secondary: secondary 
anish: anish 
shah: shah 
hagen: hagen 
rstenau: rstenau 
urban: urban 
optimizers: optimizers 
julian: julian 
taylor: taylor 
uncheckedget: uncheckedget 
pickleability: pickleability 
getnewargs: getnewargs 
massive: massive 
replacing: replacing 
setref: setref 
getsize: getsize 
telnet: telnet 
avoided: avoided 
calculated: calculated 
overreads: overreads 
necessarily: necessarily 
highly: highly 
pybyteswriter: pybyteswriter 
setrecursionlimit: setrecursionlimit 
water: water 
formula: formula 
overflowed: overflowed 
misformed: misformed 
dickinson: dickinson 
asdouble: asdouble 
microbenchmarks: microbenchmarks 
eaccess: eaccess 
bednarski: bednarski 
kalle: kalle 
tuure: tuure 
menubar: menubar 
bindfortraversal: bindfortraversal 
redirect: redirect 
janech: janech 
smtpchannel: smtpchannel 
smtpserver: smtpserver 
asynchat: asynchat 
crompton: crompton 
kluyver: kluyver 
akira: akira 
li: li 
yolanda: yolanda 
robla: robla 
userptr: userptr 
pvariance: pvariance 
median: median 
upendra: upendra 
kuma: kuma 
krah: krah 
responseerror: responseerror 
invariant: invariants 
sunos: sunos 
crle: crle 
kees: kees 
bos: bos 
unrelated: unrelated 
bypassed: bypassed 
felix: felix 
kaiser: kaiser 
joseph: joseph 
hackman: hackman 
jansen: jansen 
assertsequenceequal: assertsequenceequal 
stringified: stringified 
assertlistequal: assertlistequal 
asserttupleequal: asserttupleequal 
kumaripaba: kumaripaba 
miyurusara: miyurusara 
athukorala: athukorala 
attrgetter: attrgetter 
disassembling: disassembling 
disassembles: disassembles 
ustar: ustar 
hagemeister: hagemeister 
ized: ized 
wsgi: wsgi 
webm: webm 
geoff: geoff 
wilson: wilson 
sigwinch: sigwinch 
respond: respond 
bufferedwriter: bufferedwriter 
conforms: conforms 
docfiletest: docfiletest 
changeset: changeset 
ne: ne 
plummer: plummer 
linecache: linecache 
sigfpe: sigfpe 
sigabrt: sigabrt 
gettraceback: gettraceback 
getspnam: getspnam 
privilege: privileges 
inglesby: inglesby 
warningmessage: warningmessage 
showwarnmsg: showwarnmsg 
baji: baji 
ghost: ghost 
van: van 
den: den 
elzen: elzen 
maxyear: maxyear 
tam: tam 
bence: bence 
gedai: gedai 
amit: amit 
saha: saha 
excessive: excessive 
timespec: timespec 
impls: impls 
dupuy: dupuy 
minimized: minimized 
deepcopying: deepcopying 
dequeues: dequeues 
jakub: jakub 
stasiak: stasiak 
subnets: subnets 
maximal: maximal 
namedtemporaryfile: namedtemporaryfile 
shuts: shuts 
remotedisconnected: remotedisconnected 
adobe: adobe 
swati: swati 
jaiswal: jaiswal 
lazyloader: lazyloader 
accompanying: accompanying 
proportional: proportional 
mapresult: mapresult 
posting: posting 
fancyurlopener: fancyurlopener 
brazil: brazil 
rocco: rocco 
nyberg: nyberg 
gethostbyaddr: gethostbyaddr 
gethostbyname: gethostbyname 
sitecustomize: sitecustomize 
usercustomize: usercustomize 
expanding: expanding 
mccully: mccully 
ulrich: ulrich 
petri: petri 
portion: portion 
gmail: gmail 
samson: samson 
itertext: itertext 
iterparse: iterparse 
detecting: detecting 
tolerating: tolerating 
regexp: regexp 
tzset: tzset 
irrelevant: irrelevant 
marian: marian 
ganisin: ganisin 
attrib: attrib 
santoso: santoso 
listing: listing 
cap: caps cap 
uint: uint 
eventloop: eventloop 
mauro: mauro 
rodrigues: rodrigues 
joel: joel 
taddei: taddei 
eryksun: eryksun 
ryosuke: ryosuke 
ito: ito 
vandenberg: vandenberg 
dedent: dedent 
largest: largest 
substring: substring 
smallest: smallest 
smtphandler: smtphandler 
simon: simon 
pickletools: pickletools 
memoize: memoize 
bogoychev: bogoychev 
distutilsplatformerror: distutilsplatformerror 
mirroring: mirroring 
law: laws 
cgirequesthandler: cgirequesthandler 
question: question 
fromutc: fromutc 
delims: delims 
rlcompleter: rlcompleter 
nearest: nearest 
tie: ties 
alphabetically: alphabetically 
panter: panter 
belopolsky: belopolsky 
stringtypes: stringtypes 
balogh: balogh 
lawrence: lawrence 
recurse: recurse 
infinitely: infinitely 
nicola: nicola 
palumbo: palumbo 
laurent: laurent 
buyst: buyst 
ignacio: ignacio 
rossi: rossi 
getmoduleinfo: getmoduleinfo 
getpeercer: getpeercer 
nonblocking: nonblocking 
reinitialized: reinitialized 
jiryu: jiryu 
readuntil: readuntil 
confighelpsourceedit: confighelpsourceedit 
iobinding: iobinding 
unwanted: unwanted 
engine: engine 
runtimeerrors: runtimeerrors 
caught: caught 
activating: activating 
suspend: suspend 
vwait: vwait 
appearance: appearance 
currenttheme: currenttheme 
everywhere: everywhere 
inverted: inverted 
cobalt: cobalt 
blue: blue 
green: green 
orange: orange 
november: november 
curious: curious 
integrated: integrated 
learning: learning 
highlighting: highlighting 
inactive: inactive 
highlighted: highlighted 
scrolledlist: scrolledlist 
messageboxes: messageboxes 
sheet: sheet 
pitch: pitch 
light: light 
blueish: blueish 
condense: condense 
idleib: idleib 
rstripped: rstripped 
rose: rose 
helpdialog: helpdialog 
helt: helt 
idlever: idlever 
mattip: mattip 
loyse: loyse 
testdir: testdir 
svn: svn 
extracted: extracted 
alecsandru: alecsandru 
patrascu: patrascu 
richard: richard 
oudkerk: oudkerk 
rt: rt 
unlimited: unlimited 
toolchains: toolchains 
thoroughly: thoroughly 
fileblocks: fileblocks 
bjoern: bjoern 
thiel: thiel 
apple: apple 
textual: textual 
excludes: excludes 
ilsche: ilsche 
shaulov: shaulov 
programmatical: programmatical 
privileged: privileged 
controlled: controlled 
upcoming: upcoming 
decodeescape: decodeescape 
jay: jay 
bosamiya: bosamiya 
rebased: rebased 
miro: miro 
hron: hron 
nick: nick 
coghlan: coghlan 
matchfile: matchfile 
summary: summary 
duration: duration 
warms: warms 
truncates: truncates 
dictitems: dictitems 
undoes: undoes 
ubuntu: ubuntu 
gave: gave 
odd: odd 
bounded: bounded 
deques: deques 
conn: conn 
cole: coles 
stdprinter: stdprinter 
backslashreplace: backslashreplace 
correspond: correspond 
openmp: openmp 
calculates: calculates 
binbytes: binbytes 
binunicode: binunicode 
numbering: numbering 
anthon: anthon 
der: der 
neut: neut 
gut: guts 
understandable: understandable 
safer: safer 
emptying: emptying 
rounded: rounded 
minus: minus 
asencodedstring: asencodedstring 
kaptur: kaptur 
charrefs: charrefs 
trapping: trapping 
expectedfailure: expectedfailure 
landry: landry 
bryce: bryce 
darling: darling 
chiu: chiu 
hsiang: hsiang 
hsu: hsu 
interpolationmissingoptionerror: interpolationmissingoptionerror 
honour: honour 
longmessage: longmessage 
assertregex: assertregex 
ilium: ilia 
kurenkov: kurenkov 
andy: andy 
overhaul: overhaul 
mktemp: mktemp 
zbigniew: zbigniew 
weston: weston 
pam: pam 
mca: mca 
nulty: nulty 
administrative: administrative 
intel: intel 
msis: msis 
uninstallation: uninstallation 
precompile: precompile 
upgrading: upgrading 
clarifies: clarifies 
requestedexecutionlevel: requestedexecutionlevel 
virtualization: virtualization 
quietly: quietly 
subsystem: subsystem 
counted: counted 
pywin: pywin 
overread: overread 
fp: fp 
syscmd: syscmd 
odict: odict 
resizes: resizes 
msvccompiler: msvccompiler 
hill: hill 
fractional: fractional 
expiry: expiry 
ssh: ssh 
frank: frank 
formatdate: formatdate 
dmitry: dmitry 
shachnev: shachnev 
authenticator: authenticator 
bigendianstructure: bigendianstructure 
gautier: gautier 
tcpserver: tcpserver 
luca: luca 
sbardella: sbardella 
mohd: mohd 
sanad: sanad 
zaki: zaki 
rizvi: rizvi 
courier: courier 
tkfixedfont: tkfixedfont 
fontxxx: fontxxx 
adnan: adnan 
umer: umer 
tearoff: tearoff 
familiar: familiar 
introduction: introduction 
dorian: dorian 
pula: pula 
sentence: sentence 
yongzhi: yongzhi 
pan: pan 
rfind: rfind 
consequence: consequence 
plug: plug 
rcompleter: rcompleter 
displaying: displaying 
sekera: sekera 
inappropriate: inappropriate 
eduardo: eduardo 
seabra: seabra 
evilzero: evilzero 
readerror: readerror 
kai: kai 
groner: groner 
getcoroutinestate: getcoroutinestate 
getcoroutinelocals: getcoroutinelocals 
gi: gi 
yieldfrom: yieldfrom 
benno: benno 
leslie: leslie 
tolerates: tolerates 
untokenize: untokenize 
adpcm: adpcm 
disturb: disturb 
polar: polar 
metric: metrics 
getitemwitherror: getitemwitherror 
superfluous: superfluous 
defend: defend 
testmultiphase: testmultiphase 
combining: combining 
endswith: endswith 
istrue: istrue 
cjk: cjk 
isclose: isclose 
barker: barker 
tal: tal 
einat: einat 
ratecv: ratecv 
weightb: weightb 
powell: powell 
faked: faked 
clement: clement 
rouault: rouault 
front: front 
delegated: delegated 
unnormalized: unnormalized 
joiner: joiner 
kachayev: kachayev 
casefold: casefold 
isprintable: isprintable 
maketrans: maketrans 
devin: devin 
jeanpierre: jeanpierre 
assertments: assertments 
wagner: wagner 
rawiobase: rawiobase 
laura: laura 
rupprecht: rupprecht 
evaluable: evaluable 
gettempdir: gettempdir 
mkdtemp: mkdtemp 
chosen: chosen 
mkstemp: mkstemp 
strengthen: strengthen 
fcicreate: fcicreate 
fci: fci 
armstrong: armstrong 
urlencode: urlencode 
mangle: mangle 
koi: koi 
kz: kz 
peek: peek 
hergenroeder: hergenroeder 
bitmime: bitmime 
heapify: heapify 
heapifying: heapifying 
usernames: usernames 
complains: complains 
varargs: varargs 
getint: getint 
getdouble: getdouble 
kazakov: kazakov 
poorly: poorly 
sequential: sequential 
lifoqueue: lifoqueue 
priorityqueue: priorityqueue 
joinablequeue: joinablequeue 
boundedsemaphore: boundedsemaphore 
boundargument: boundargument 
overloaded: overloaded 
bayer: bayer 
sweigart: sweigart 
christie: christie 
createfilehandler: createfilehandler 
man: man 
patchcheck: patchcheck 
checkout: checkouts 
kfreebsd: kfreebsd 
easy: easy 
abis: abis 
courtesy: courtesy 
pyo: pyo 
wine: wine 
credential: credentials 
supersedes: supersedes 
demian: demian 
brecht: brecht 
ndigits: ndigits 
extractall: extractall 
vogt: vogt 
calledprocess: calledprocess 
ballinger: ballinger 
allison: allison 
pycompileerror: pycompileerror 
blowing: blowing 
allocating: allocating 
ram: ram 
boquien: boquien 
bom: bom 
decompressed: decompressed 
lzmafile: lzmafile 
defeat: defeats 
bomb: bombs 
nikolaus: nikolaus 
rath: rath 
subprocesserror: subprocesserror 
wild: wild 
defragresult: defragresult 
parseresult: parseresult 
splitresult: splitresult 
defragresultbytes: defragresultbytes 
parseresultbytes: parseresultbytes 
splitresultbytes: splitresultbytes 
ftpwrapper: ftpwrapper 
orderable: orderable 
tkapp: tkapp 
getboolean: getboolean 
booleanvar: booleanvar 
parsestring: parsestring 
makoto: makoto 
kato: kato 
inputsource: inputsource 
sendto: sendto 
interruptederror: interruptederror 
commonpath: commonpath 
rafik: rafik 
draoui: draoui 
lookupable: lookupable 
mapped: mapped 
retried: retried 
recomputed: recomputed 
imul: imul 
kasia: kasia 
jachim: jachim 
soversion: soversion 
nnnn: nnnn 
pot: pot 
understanding: understanding 
parsetuple: parsetuple 
smarter: smarter 
ifndef: ifndef 
methoddef: methoddef 
reinitlock: reinitlock 
ucs: ucs 
dimensional: dimensional 
cauet: cauet 
sized: sized 
groupindex: groupindex 
modifiable: modifiable 
pipepager: pipepager 
isbadstringptr: isbadstringptr 
expandvars: expandvars 
loses: loses 
bufferedrwpair: bufferedrwpair 
consist: consist 
tetxtwrap: tetxtwrap 
complexity: complexity 
pyz: pyz 
pyzw: pyzw 
unseekable: unseekable 
maxline: maxline 
substitutability: substitutability 
sigwaitinfo: sigwaitinfo 
sigtimedwait: sigtimedwait 
sigset: sigset 
recomputes: recomputes 
carroll: carroll 
bohuslav: bohuslav 
kabrda: kabrda 
fake: fake 
picklable: picklable 
morsel: morsel 
transform: transform 
gindi: gindi 
rdivmod: rdivmod 
kan: kan 
vdahl: vdahl 
htmldiff: htmldiff 
ftruncate: ftruncate 
absent: absent 
unordered: unordered 
alon: alon 
diamant: diamant 
matmul: matmul 
wei: wei 
wu: wu 
hoyt: hoyt 
bkfile: bkfile 
consumption: consumption 
trusted: trusted 
stalling: stalling 
flatten: flatten 
corrected: corrected 
lookbehind: lookbehind 
aleksi: aleksi 
torhamo: torhamo 
closefd: closefd 
apropos: apropos 
paugh: paugh 
steven: steven 
bethard: bethard 
eriksson: eriksson 
average: average 
wdv: wdv 
yeo: yeo 
entire: entire 
preamble: preamble 
og: og 
versioned: versioned 
ascharbuffer: ascharbuffer 
asreadbuffer: asreadbuffer 
aswritebuffer: aswritebuffer 
constituted: constituted 
encodembcs: encodembcs 
encodecodepage: encodecodepage 
campbell: campbell 
barton: barton 
translating: translating 
shellexecute: shellexecute 
aw: aw 
startfile: startfile 
pyatomic: pyatomic 
lima: lima 
temple: temple 
aka: aka 
printf: printf 
renaud: renaud 
blanch: blanch 
existent: existent 
pylifecycle: pylifecycle 
enlarge: enlarge 
fffffff: fffffff 
swapcase: swapcase 
dividing: dividing 
xmlcharrefreplace: xmlcharrefreplace 
formatv: formatv 
illumos: illumos 
enotty: enotty 
getfd: getfd 
setfd: setfd 
enomem: enomem 
slotdefs: slotdefs 
qualified: qualified 
pessimistic: pessimistic 
noticeable: noticeable 
flaw: flaw 
concat: concat 
concatenate: concatenate 
fpu: fpu 
unicodetranslateerror: unicodetranslateerror 
andreas: andreas 
schwab: schwab 
ingebretson: ingebretson 
ysj: ysj 
ray: ray 
managing: managing 
carry: carry 
spark: spark 
leon: leon 
regard: regard 
phil: phil 
elson: elson 
ramchandra: ramchandra 
apte: apte 
torsten: torsten 
landschoff: landschoff 
rejected: rejected 
corrupting: corrupting 
permutation: permutations 
basestring: basestring 
throwflag: throwflag 
swapped: swapped 
tellable: tellable 
zipextfiles: zipextfiles 
jsondecodeerror: jsondecodeerror 
collapse: collapse 
consecutive: consecutive 
submitted: submitted 
nly: nly 
baseselector: baseselector 
rendered: rendered 
tripathi: tripathi 
openssls: openssls 
functool: functool 
detached: detached 
pseudo: pseudo 
binput: binput 
tunnel: tunnel 
vfat: vfat 
presumably: presumably 
ward: ward 
epollselector: epollselector 
xmlrpclib: xmlrpclib 
reopen: reopen 
operate: operate 
getresponse: getresponse 
pach: pach 
rand: rand 
egd: egd 
bernard: bernard 
spil: spil 
namereplace: namereplace 
absence: absence 
stricter: stricter 
ludovic: ludovic 
gasc: gasc 
asicpriorauthhandler: asicpriorauthhandler 
matej: matej 
reprlib: reprlib 
ported: ported 
netstat: netstat 
aivars: aivars 
kalv: kalv 
brought: brought 
samefileerror: samefileerror 
chaput: chaput 
notadirectoryerror: notadirectoryerror 
virtualbox: virtualbox 
delocalize: delocalize 
nain: nain 
subparser: subparser 
examine: examine 
testloader: testloader 
throughout: throughout 
stronger: stronger 
multilevel: multilevel 
conversionerror: conversionerror 
xdrlib: xdrlib 
filip: filip 
gruszczy: gruszczy 
ski: ski 
unmatched: unmatched 
subn: subn 
sndhdr: sndhdr 
whathdr: whathdr 
geert: geert 
whichmodule: whichmodule 
olivier: olivier 
grisel: grisel 
chunksize: chunksize 
batching: batching 
reilly: reilly 
relpath: relpath 
mismatched: mismatched 
consult: consult 
fadvise: fadvise 
showtraceback: showtraceback 
oshmyan: oshmyan 
joshua: joshua 
oliva: oliva 
central: central 
allowzip: allowzip 
groupref: groupref 
emailmessage: emailmessage 
nntperror: nntperror 
gaynor: gaynor 
cook: cook 
lax: lax 
bobrov: bobrov 
tarek: tarek 
ziad: ziad 
loadtestsfrommodule: loadtestsfrommodule 
tweaked: tweaked 
warsaw: warsaw 
stripped: stripped 
heading: heading 
keyerrors: keyerrors 
cleaner: cleaner 
reloads: reloads 
lita: lita 
cho: cho 
pane: pane 
drawing: drawing 
grabbed: grabbed 
dragged: dragged 
widened: widened 
easily: easily 
kanis: kanis 
disappear: disappear 
shrunk: shrunk 
obvious: obvious 
starttls: starttls 
littleendianstructure: littleendianstructure 
doug: doug 
zongker: zongker 
realtime: realtime 
librt: librt 
risky: risky 
shahaf: shahaf 
nodefaultroot: nodefaultroot 
rfcs: rfcs 
bull: bull 
iterkeys: iterkeys 
itervalues: itervalues 
iteritems: iteritems 
forgets: forgets 
delhallt: delhallt 
powerpc: powerpc 
elf: elf 
abiv: abiv 
fileexistserrors: fileexistserrors 
htmlparsererror: htmlparsererror 
defers: defers 
fine: fine 
chat: chat 
blockingioerror: blockingioerror 
premature: premature 
tom: tom 
flanagan: flanagan 
xterm: xterm 
dated: dated 
hexadecimal: hexadecimal 
fileobj: fileobj 
ran: ran 
viewing: viewing 
terminator: terminator 
kwonlyargcount: kwonlyargcount 
july: july 
tikhonov: tikhonov 
setvalueex: setvalueex 
ehresman: ehresman 
torres: torres 
navarrete: navarrete 
bytesparser: bytesparser 
discarded: discarded 
openexr: openexr 
reaping: reaping 
uploading: uploading 
dengler: dengler 
unquoting: unquoting 
printout: printout 
doctests: doctests 
nonnormalized: nonnormalized 
tmpfile: tmpfile 
writedoc: writedoc 
proc: proc 
letting: letting 
bubble: bubble 
world: world 
draft: draft 
sapin: sapin 
wantobject: wantobject 
truly: truly 
symlinking: symlinking 
webp: webp 
fabrice: fabrice 
aneche: aneche 
locked: locked 
listen: listen 
assistance: assistance 
helping: helping 
nontrivial: nontrivial 
shape: shape 
summarize: summarize 
netmasks: netmasks 
fullmatch: fullmatch 
matthew: matthew 
barnett: barnett 
samefile: samefile 
execcodemoduleobject: execcodemoduleobject 
friend: friends 
netmask: netmask 
inspectloader: inspectloader 
heaqp: heaqp 
nlargest: nlargest 
nmsmallest: nmsmallest 
junction: junctions 
gr: gr 
sman: sman 
watchexp: watchexp 
quantize: quantize 
unusable: unusable 
mappingviews: mappingviews 
anton: anton 
afanasyev: afanasyev 
sslwantreaderror: sslwantreaderror 
sslwantwriteerror: sslwantwriteerror 
dispatcher: dispatcher 
interprets: interprets 
temporaryfilewrapper: temporaryfilewrapper 
temporaryfilecloser: temporaryfilecloser 
facility: facility 
mindom: mindom 
uris: uris 
xattrs: xattrs 
incase: incase 
assret: assret 
deterministically: deterministically 
jure: jure 
koren: koren 
venvs: venvs 
disconnect: disconnect 
violating: violating 
conformance: conformance 
rset: rset 
smtpserverdisconnected: smtpserverdisconnected 
kushal: kushal 
da: das 
baiter: baiter 
guido: guido 
vranken: vranken 
getpass: getpass 
pyflakes: pyflakes 
elliptic: elliptic 
exchange: exchange 
prioritize: prioritize 
perfect: perfect 
secrecy: secrecy 
waste: waste 
usuable: usuable 
unhelpful: unhelpful 
grok: grok 
otten: otten 
outsize: outsize 
getcallargs: getcallargs 
jeremiah: jeremiah 
lowin: lowin 
hirokazu: hirokazu 
amaury: amaury 
forgeot: forgeot 
gutteridge: gutteridge 
hashable: hashable 
doctestsuite: doctestsuite 
testsuite: testsuite 
corowrapper: corowrapper 
cpythons: cpythons 
szakmeister: szakmeister 
topmost: topmost 
zach: zach 
byrne: byrne 
prep: prep 
extending: extending 
establishing: establishing 
ms: mss 
nagle: nagle 
formatparagraph: formatparagraph 
breakpoints: breakpoints 
apt: apt 
hyperparser: hyperparser 
widgetredirector: widgetredirector 
searchdialogbase: searchdialogbase 
webster: webster 
autoexpand: autoexpand 
saihadhav: saihadhav 
consolidating: consolidating 
validated: validated 
reformat: reformat 
prog: prog 
borland: borland 
djgpp: djgpp 
hosmer: hosmer 
jonas: jonas 
zachary: zachary 
turner: turner 
suspicious: suspicious 
linkcheck: linkcheck 
addresssanitizer: addresssanitizer 
ncursesw: ncursesw 
berkeleydb: berkeleydb 
regenerates: regenerates 
externally: externally 
bundlebuilder: bundlebuilder 
incorporated: incorporated 
anticipated: anticipated 
vc: vc 
official: official 
pyd: pyd 
cabinet: cabinet 
fillinfo: fillinfo 
getbuffer: getbuffer 
bytesiobuf: bytesiobuf 
getbuf: getbuf 
buffererror: buffererror 
iscontiguous: iscontiguous 
precise: precise 
contiguity: contiguity 
npy: npy 
stride: strides 
rawcalloc: rawcalloc 
calloc: calloc 
importfrozenmoduleobject: importfrozenmoduleobject 
distinction: distinction 
clarification: clarifications 
obsoleted: obsoleted 
derive: derive 
undocument: undocument 
foobar: foobar 
mccracken: mccracken 
ca: ca 
organization: organizations 
authority: authority 
recorded: recorded 
remi: remi 
pointel: pointel 
somewhat: somewhat 
assorted: assorted 
denver: denver 
coneybeare: coneybeare 
radu: radu 
voicilas: voicilas 
filtering: filtering 
software: software 
interfere: interfere 
lennart: lennart 
regebro: regebro 
listbox: listbox 
itemconfigure: itemconfigure 
panedwindow: panedwindow 
paneconfigure: paneconfigure 
entryconfigure: entryconfigure 
consolidated: consolidated 
geometry: geometry 
pkgs: pkgs 
libz: libz 
zc: zc 
typedefs: typedefs 
makelocalealias: makelocalealias 
ryan: ryan 
ware: ware 
meador: meador 
inge: inge 
pythonwarning: pythonwarning 
vista: vista 
tip: tip 
nasm: nasm 
pulled: pulled 
olive: olive 
kilburn: kilburn 
copyright: copyright 
foundation: foundation 
profit: profit 
corporation: corporation 
donate: donate 
archived: archived 
retrieved: retrieved 
playback: playback 
exclusion: exclusion 
rediscdxsource: rediscdxsource 
esindex: esindex 
loadshardblock: loadshardblock 
petaboxloader: petaboxloader 
datanode: datanode 
cdxlines: cdxlines 
