donald: donald 
trump: trump trumps 
impeachment: impeachment 
presidency: presidency 
education: education 
biography: biography 
skip: skip 
main: main 
content: content 
people: people 
nostalgia: nostalgia 
celebrity: celebrity 
history: history 
culture: culture 
crime: crimes crime 
scandal: scandal 
video: video 
contact: contact contacts 
u: us u 
advertise: advertise 
privacy: privacy 
notice: notice 
term: term terms 
use: use 
copyright: copyright 
policy: policies policy 
ad: ad 
choice: choices choice 
accessibility: accessibility 
support: supports support 
setting: settings 
february: february 
subscribe: subscribe 
newsletter: newsletter 
photo: photos photo 
michael: michael 
stewart: stewart 
wireimage: wireimage 
quick: quick 
fact: facts fact 
name: name names 
birth: birth 
date: date 
june: june 
age: age 
fordham: fordham 
university: university 
wharton: wharton 
school: school schools 
finance: finance 
new: new 
york: york 
military: military 
academy: academy 
place: place 
queen: queens 
full: full 
john: john 
zodiac: zodiac 
sign: sign 
gemini: gemini 
cite: cite 
page: pages page 
quote: quotes 
going: going 
tough: tough 
time: times time 
wonderful: wonderful 
thing: thing things 
everybody: everybody 
try: try 
publish: publish 
apr: apr 
comment: comment comments 
billionaire: billionaire 
real: real 
estate: estate 
mogul: mogul 
former: former 
reality: reality 
television: television 
personality: personality 
th: th 
president: president presidents 
united: united 
state: state states 
took: took 
office: office 
january: january 
previously: previously 
tv: tv 
star: star 
opened: opened 
grand: grand 
hyatt: hyatt 
made: made 
city: city 
best: best 
known: known 
developer: developers developer 
xa: xa 
began: began 
starring: starring 
hit: hit 
nbc: nbc 
series: series 
apprentice: apprentice 
turned: turned 
attention: attention 
politics: politics 
announced: announced 
candidacy: candidacy 
republican: republicans republican 
ticket: ticket 
became: became 
official: officials official 
candidate: candidates candidate 
july: july 
upset: upset 
democratic: democratic 
hillary: hillary 
clinton: clinton 
november: november 
become: become 
four: four 
year: years year 
later: later 
lost: lost 
bid: bid 
reelection: reelection 
vice: vice 
joe: joe 
biden: biden 
early: early 
life: life lives 
born: born 
energetic: energetic 
assertive: assertive 
child: children child 
wealth: wealth 
increased: increased 
postwar: postwar 
boom: boom 
raised: raised 
presbyterian: presbyterian 
mother: mother 
identifies: identifies 
mainline: mainline 
protestant: protestant 
parent: parents 
sent: sent 
hoping: hoping 
discipline: discipline 
would: would 
channel: channel 
energy: energy 
positive: positive 
manner: manner 
well: well 
socially: socially 
academically: academically 
rising: rising 
athlete: athlete 
student: student students 
leader: leaders leader 
graduated: graduated 
entered: entered 
transferred: transferred 
pennsylvania: pennsylvania 
two: two 
degree: degree 
economics: economics 
college: college 
worked: worked 
father: father 
business: business businesses 
summer: summer 
also: also 
secured: secured 
deferment: deferments deferment 
draft: draft 
vietnam: vietnam 
war: wars war 
ultimately: ultimately 
medical: medical 
sibling: siblings 
frederick: frederick 
builder: builder 
specialized: specialized 
constructing: constructing 
operating: operating 
middle: middle 
income: income 
apartment: apartments 
staten: staten 
island: island 
brooklyn: brooklyn 
mary: mary 
macleod: macleod 
immigrated: immigrated 
tong: tong 
scotland: scotland 
fred: fred 
married: married 
couple: couple 
settled: settled 
jamaica: jamaica 
neighborhood: neighborhood 
filled: filled 
western: western 
european: european 
immigrant: immigrants 
family: families family 
socialite: socialite 
philanthropist: philanthropist 
died: died 
passed: passed 
away: away 
following: following 
fourth: fourth 
five: five 
maryanne: maryanne 
barry: barry 
senior: senior 
judge: judges judge 
court: court courts 
appeal: appeals appeal 
third: third 
circuit: circuit 
inactive: inactive 
stats: stats 
soon: soon 
brother: brother 
jr: jr 
briefly: briefly 
pilot: pilot 
struggled: struggled 
alcohol: alcohol 
prompting: prompting 
announce: announce 
never: never 
drink: drinks 
take: take 
drug: drug drugs 
profound: profound 
impact: impact 
know: know knows 
end: end 
said: said 
elizabeth: elizabeth 
grau: grau 
retired: retired 
banker: banker 
film: film 
producer: producer 
james: james 
robert: robert roberts 
younger: younger 
spent: spent 
much: much 
career: career 
working: working 
company: company companies 
aged: aged 
opening: opening 
wollman: wollman 
rink: rink 
dennis: dennis 
caruso: caruso 
ny: ny 
daily: daily 
news: news 
archive: archive 
via: via 
getty: getty 
image: images 
wife: wives wife 
melania: melania 
currently: currently 
slovenian: slovenian 
model: model 
n: n 
xe: xe 
e: e 
knauss: knauss 
junior: junior 
highly: highly 
publicized: publicized 
lavish: lavish 
wedding: wedding 
among: among 
many: many 
guest: guests 
bill: bill 
ivana: ivana 
first: first 
zelnickova: zelnickova 
winklmayr: winklmayr 
fashion: fashion 
alternate: alternate 
czech: czech 
olympic: olympic 
ski: ski 
team: team 
named: named 
charge: charge charges 
design: design 
organization: organization organizations 
played: played 
major: major 
role: roles role 
supervising: supervising 
renovation: renovation 
commodore: commodore 
plaza: plaza 
hotel: hotel 
three: three 
together: together 
ivanka: ivanka 
eric: eric 
went: went 
divorce: divorce 
finalized: finalized 
marla: marla 
maple: maples 
second: second 
actress: actress 
involved: involved 
already: already 
daughter: daughter 
tiffany: tiffany 
file: file 
final: final 
prenuptial: prenuptial 
agreement: agreements agreement 
allotted: allotted 
million: millions million 
current: current 
gave: gave 
youngest: youngest 
barron: barron 
william: william 
march: march 
son: son sons 
work: work 
executive: executive 
serf: serves 
left: left 
label: label 
join: join joins 
administration: administration 
unpaid: unpaid 
assistant: assistant 
husband: husband 
jared: jared 
kushner: kushner 
adviser: advisers adviser 
sit: sit 
table: table 
mar: mar 
lago: lago 
davidoff: davidoff 
studio: studios 
followed: followed 
development: development 
bringing: bringing 
grander: grander 
ambition: ambitions 
venture: ventures venture 
include: include 
tower: tower 
casino: casinos 
atlantic: atlantic 
franchise: franchises 
like: likes like 
miss: miss 
universe: universe 
deal: deal deals 
javits: javits 
center: center 
florida: florida 
los: los 
angeles: angeles 
federal: federal 
disclosure: disclosure 
form: form forms 
filed: filed 
list: list 
golf: golf 
course: course courses 
including: including 
national: nationals national 
doral: doral 
earning: earning 
half: half 
financial: financial 
aircraft: aircraft 
merchandise: merchandise 
royalty: royalties 
book: books book 
art: arts art 
crippled: crippled 
america: america 
make: makes make 
great: great 
published: published 
co: co 
authored: authored 
tony: tony 
schwartz: schwartz 
describes: describes 
successfully: successfully 
x: x 
c: c 
money: money 
got: got 
enough: enough 
ever: ever 
need: need 
wrote: wrote 
seller: seller 
although: although 
number: number 
copy: copies 
sold: sold 
debated: debated 
sale: sales 
estimated: estimated 
outspoken: outspoken 
critic: critic critics 
saying: saying 
felt: felt 
remorseful: remorseful 
helping: helping 
appealing: appealing 
net: net 
worth: worth 
subject: subject 
public: public 
debate: debates debate 
publicly: publicly 
released: released 
tax: tax taxes 
return: returns 
possible: possible 
definitively: definitively 
determine: determine 
past: past 
today: today 
however: however 
valued: valued 
least: least 
billion: billion 
government: government 
ethic: ethics 
put: put 
revenue: revenue 
minimum: minimum 
source: sources 
asserted: asserted 
market: market 
decline: decline 
reducing: reducing 
value: value 
empire: empire 
required: required 
massive: massive 
infusion: infusion 
loan: loans 
keep: keep 
collapsing: collapsing 
situation: situation 
question: questions question 
whether: whether 
corporation: corporation 
could: could 
survive: survive 
bankruptcy: bankruptcy 
observer: observers 
saw: saw 
symbolic: symbolic 
economic: economic 
social: social 
excess: excesses 
arisen: arisen 
may: may 
investigation: investigation investigations 
information: information 
found: found 
every: every 
newspaper: newspaper 
calculated: calculated 
suffered: suffered 
loss: losses 
decade: decades decade 
defended: defended 
twitter: twitter 
calling: calling 
report: reports report 
inaccurate: inaccurate 
fake: fake 
job: job 
tweeted: tweeted 
reported: reported 
purpose: purpose purposes 
sport: sports sport 
questioned: questioned 
presidential: presidential 
run: run 
courted: courted 
controversy: controversy 
repeatedly: repeatedly 
refusing: refusing 
release: release 
audited: audited 
internal: internal 
service: services service 
election: elections election 
party: party parties 
since: since 
richard: richard 
nixon: nixon 
democrat: democrat democrats 
regained: regained 
control: controls control 
house: house 
faced: faced 
call: calls call 
april: april 
congressman: congressman 
neal: neal 
chairman: chairmen chairman 
way: way ways 
mean: means 
committee: committee committees 
requested: requested 
six: six 
personal: personal 
irs: irs 
treasury: treasury 
secretary: secretary 
steve: steve 
mnuchin: mnuchin 
rejected: rejected 
request: request 
follow: follow 
subpoena: subpoena 
document: documents 
assembly: assembly 
legislation: legislation 
authorized: authorized 
senate: senate 
joint: joint 
taxation: taxation 
specified: specified 
legitimate: legitimate 
legislative: legislative 
serving: serving 
home: home 
base: base 
believed: believed 
contain: contain 
september: september 
manhattan: manhattan 
district: districts district 
attorney: attorney 
cyrus: cyrus 
vance: vance 
subpoenaed: subpoenaed 
accounting: accounting 
firm: firm 
mazars: mazars 
usa: usa 
corporate: corporate 
dating: dating 
back: back 
challenge: challenge challenges 
lawyer: lawyer lawyers 
dismissed: dismissed 
lawsuit: lawsuits lawsuit 
october: october 
though: though 
nd: nd 
agreed: agreed 
temporarily: temporarily 
delay: delay 
enforcement: enforcement 
considering: considering 
argument: arguments 
case: cases case 
day: days day 
block: block 
another: another 
issued: issued 
one: one 
oversight: oversight 
reform: reform 
supreme: supreme 
hear: hear 
congressional: congressional 
december: december 
presented: presented 
paid: paid 
nothing: nothing 
previous: previous 
replied: replied 
appear: appear 
fair: fair 
housing: housing 
act: act 
discrimination: discrimination 
trial: trial 
complaint: complaint 
alleging: alleging 
discriminated: discriminated 
tenant: tenants 
potential: potential 
based: based 
race: races race 
violation: violations violation 
part: part 
civil: civil 
right: right rights 
lengthy: lengthy 
legal: legal 
battle: battle battles 
train: train 
employee: employees 
inform: inform 
community: community communities 
practice: practices 
resolution: resolution 
memoir: memoir 
prove: prove 
ended: ended 
taking: taking 
minor: minor 
settlement: settlement settlements 
without: without 
admitting: admitting 
guilt: guilt 
launched: launched 
profit: profits profit 
offering: offering 
class: classes class 
acquiring: acquiring 
managing: managing 
scrutiny: scrutiny 
almost: almost 
inception: inception 
remained: remained 
multiple: multiple 
claimant: claimants 
accused: accused 
fraud: fraud 
false: false 
advertising: advertising 
breach: breach 
contract: contract 
suit: suit suits 
headline: headlines 
suggested: suggested 
gonzalo: gonzalo 
curiel: curiel 
impartial: impartial 
overseeing: overseeing 
action: actions action 
mexican: mexican 
heritage: heritage 
vowed: vowed 
matter: matters matter 
admission: admission 
liability: liability 
statement: statement statements 
general: general 
schneiderman: schneiderman 
called: called 
stunning: stunning 
reversal: reversal 
victory: victory 
victim: victims 
fraudulent: fraudulent 
j: j 
foundation: foundation 
separate: separate 
incident: incident 
related: related 
pam: pam 
bondi: bondi 
decided: decided 
existing: existing 
came: came 
received: received 
sizable: sizable 
campaign: campaign 
donation: donation donations 
founded: founded 
private: private 
charity: charity 
designed: designed 
nonprofit: nonprofit 
group: groups group 
contender: contender 
result: result results 
improper: improper 
pay: pay 
penalty: penalty 
fund: funds fund 
non: non 
charitable: charitable 
activity: activity activities 
according: according 
record: record records 
gift: gift gifts 
come: come 
outside: outside 
contributor: contributors 
fall: fall 
admitted: admitted 
misusing: misusing 
promote: promote 
settle: settle 
debt: debt debts 
ordered: ordered 
damage: damages 
forced: forced 
shutter: shutter 
door: doors 
political: political 
registered: registered 
switched: switched 
several: several 
independent: independent 
ran: ran 
platform: platforms platform 
allow: allow 
finally: finally 
returned: returned 
endorse: endorse 
mitt: mitt 
romney: romney 
speaks: speaks 
nominee: nominee 
listens: listens 
hofstra: hofstra 
hempstead: hempstead 
pool: pool 
v: vs v 
defying: defying 
poll: polls 
medium: media medium 
projection: projections 
majority: majority 
electoral: electoral 
vote: vote votes 
despite: despite 
losing: losing 
popular: popular 
win: win 
clinched: clinched 
contentious: contentious 
rise: rise 
considered: considered 
resounding: resounding 
rejection: rejection 
establishment: establishment 
blue: blue 
collar: collar 
american: americans american 
speech: speech 
pledge: pledge pledges 
citizen: citizens citizen 
land: land lands 
supporter: supporters supporter 
beginning: beginning 
rather: rather 
incredible: incredible 
movement: movement 
hard: hard 
men: men 
woman: woman women 
love: love 
country: country countries 
want: want wants 
better: better 
brighter: brighter 
future: future 
accepted: accepted 
nomination: nominations nomination 
convention: convention 
cleveland: cleveland 
outlined: outlined 
issue: issues issue 
tackle: tackle 
violence: violence 
economy: economy 
immigration: immigration 
trade: trade 
terrorism: terrorism 
appointment: appointment appointments 
justice: justices justice 
build: build 
border: border 
wall: walls wall 
stop: stops stop 
illegal: illegal 
gang: gangs 
pouring: pouring 
promised: promised 
renegotiate: renegotiate 
reduce: reduce 
regulation: regulations regulation 
repeal: repeal 
affordable: affordable 
care: care 
otherwise: otherwise 
obamacare: obamacare 
defend: defend 
amendment: amendment 
gun: guns gun 
rebuild: rebuild 
depleted: depleted 
asking: asking 
protecting: protecting 
share: shares share 
inauguration: inauguration 
sworn: sworn 
chief: chief 
oath: oath 
placing: placing 
hand: hands hand 
bible: bible 
used: used 
abraham: abraham 
lincoln: lincoln 
sunday: sunday 
church: church 
inaugural: inaugural 
populist: populist 
message: message 
truly: truly 
controlled: controlled 
remembered: remembered 
ruler: rulers 
nation: nations nation 
paint: paint 
bleak: bleak 
picture: picture 
failed: failed 
describing: describing 
trapped: trapped 
poverty: poverty 
ineffective: ineffective 
system: system 
carnage: carnage 
protester: protesters protester 
demonstrated: demonstrated 
across: across 
around: around 
world: world 
washington: washington 
drew: drew 
protest: protests protest 
stance: stance stances 
variety: variety 
ranging: ranging 
environmental: environmental 
protection: protections protection 
dance: dances 
liberty: liberties liberty 
ball: ball 
rob: rob 
carr: carr 
lasted: lasted 
order: orders order 
good: good goods 
promise: promises promise 
aimed: aimed 
rolling: rolling 
obama: obama 
key: key 
included: included 
step: steps step 
toward: toward 
building: building 
mexico: mexico 
travel: travel 
ban: ban bans 
predominantly: predominantly 
muslim: muslim 
move: move moves 
dismantle: dismantle 
withdrawal: withdrawal 
paris: paris 
climate: climates climate 
addition: addition 
signed: signed 
implement: implement 
hiring: hiring 
freeze: freeze 
withdraw: withdraw 
trans: trans 
pacific: pacific 
partnership: partnership 
reinstate: reinstate 
funding: funding 
nongovernmental: nongovernmental 
abroad: abroad 
perform: perform 
abortion: abortions abortion 
scale: scale 
dodd: dodd 
frank: frank 
created: created 
congress: congress 
crisis: crisis 
lifetime: lifetime 
foreign: foreign 
lobbying: lobbying 
member: members 
lobbyings: lobbyings 
proposed: proposed 
budget: budget 
plan: plans plan 
spending: spending 
veteran: veterans 
affair: affairs affair 
security: security 
drastic: drastic 
cut: cut cuts 
agency: agency agencies 
department: department 
elimination: elimination 
endowment: endowment 
humanity: humanities 
broadcasting: broadcasting 
grant: grant 
program: programs program 
meal: meals 
wheel: wheels 
proved: proved 
controversial: controversial 
restored: restored 
nominated: nominated 
neil: neil 
gorsuch: gorsuch 
brett: brett 
kavanaugh: kavanaugh 
amy: amy 
coney: coney 
barrett: barrett 
old: old 
conservative: conservative 
appointed: appointed 
george: george 
w: w 
bush: bush 
denver: denver 
educated: educated 
columbia: columbia 
harvard: harvard 
oxford: oxford 
clerked: clerked 
byron: byron 
white: white 
anthony: anthony 
kennedy: kennedy 
merrick: merrick 
garland: garland 
replace: replace 
late: late 
antonin: antonin 
scalia: scalia 
denied: denied 
confirmation: confirmation 
hearing: hearings hearing 
philosophy: philosophy 
similar: similar 
strong: strong 
praise: praise 
side: sides side 
aisle: aisle 
voter: voters 
single: single 
important: important 
voted: voted 
man: man 
word: words word 
keeping: keeping 
nominating: nominating 
testimony: testimony 
judiciary: judiciary 
convened: convened 
advance: advance 
mostly: mostly 
held: held 
deny: deny 
necessary: necessary 
proceed: proceed 
resulting: resulting 
successful: successful 
partisan: partisan 
filibuster: filibuster 
quickly: quickly 
countered: countered 
historic: historic 
invoking: invoking 
nuclear: nuclear 
option: options option 
lower: lower 
threshold: threshold 
advancing: advancing 
simple: simple 
confirmed: confirmed 
retirement: retirement 
textualist: textualist 
originalist: originalist 
mold: mold 
continued: continued 
rightward: rightward 
push: push 
fight: fight 
nearly: nearly 
derailed: derailed 
accusation: accusations accusation 
sexual: sexual 
assault: assault 
earned: earned 
close: close 
death: death deaths 
liberal: liberal 
favorite: favorite 
ruth: ruth 
bader: bader 
ginsburg: ginsburg 
seventh: seventh 
change: change changes 
hoax: hoax 
recanted: recanted 
think: think 
probably: probably 
difference: difference 
interview: interviews interview 
fox: fox 
scientist: scientists 
agenda: agenda 
unconvinced: unconvinced 
human: humans 
responsible: responsible 
temperature: temperatures 
assessment: assessment 
compiled: compiled 
epa: epa 
unchecked: unchecked 
catastrophic: catastrophic 
told: told 
reporter: reporters 
believe: believe 
met: met 
prince: prince 
charles: charles 
reportedly: reportedly 
discussed: discussed 
length: length 
british: british 
host: host 
pier: piers 
morgan: morgan 
weather: weather 
global: global 
warming: warming 
actually: actually 
extreme: extreme 
itv: itv 
morning: morning 
britain: britain 
pushed: pushed 
suggestion: suggestion suggestions 
combat: combat 
cleanest: cleanest 
statistic: statistics 
withdrew: withdrew 
joined: joined 
along: along 
accord: accord accords 
requires: requires 
participating: participating 
greenhouse: greenhouse 
gas: gas 
emission: emissions 
effort: effort efforts 
curb: curb 
ensuing: ensuing 
century: century 
allocate: allocate 
resource: resources 
research: research 
alternative: alternative 
decision: decisions decision 
syria: syria 
nicaragua: nicaragua 
reject: reject 
eventually: eventually 
month: months month 
oil: oil 
extraction: extraction 
revived: revived 
keystone: keystone 
xl: xl 
dakota: dakota 
access: access 
pipeline: pipeline pipelines 
transfer: transfer 
extracted: extracted 
canada: canada 
north: north 
halted: halted 
native: native 
owned: owned 
partner: partners 
construction: construction 
stake: stake 
ceo: ceo 
kelcy: kelcy 
warren: warren 
contributed: contributed 
raising: raising 
concern: concerns concern 
conflict: conflict 
interest: interest 
coal: coal 
mining: mining 
surrounded: surrounded 
miner: miners 
independence: independence 
roll: roll 
clean: clean 
power: power 
carbon: carbon 
rescind: rescind 
moratorium: moratorium 
endangered: endangered 
specie: species 
august: august 
overhauling: overhauling 
discretion: discretion 
cost: cost 
determining: determining 
protected: protected 
addressing: addressing 
crowd: crowd 
scott: scott 
olson: olson 
health: health 
waive: waive 
defer: defer 
exemption: exemption exemptions 
aspect: aspects 
minimize: minimize 
burden: burden 
insurer: insurers 
individual: individual individuals 
led: led 
speaker: speaker 
paul: paul 
ryan: ryan 
introduced: introduced 
aca: aca 
withdrawn: withdrawn 
week: weeks week 
representing: representing 
setback: setback 
intense: intense 
negotiation: negotiations 
faction: factions 
brought: brought 
representative: representatives 
slim: slim 
margin: margin margins 
buck: buck 
immediately: immediately 
unveiled: unveiled 
senator: senators senator 
ted: ted 
cruz: cruz 
declared: declared 
failure: failure failures 
significantly: significantly 
premium: premiums 
moderate: moderates 
susan: susan 
collins: collins 
voiced: voiced 
steep: steep 
medicaid: medicaid 
mitch: mitch 
mcconnell: mcconnell 
elected: elected 
planned: planned 
skinny: skinny 
forth: forth 
lindsey: lindsey 
graham: graham 
south: south 
carolina: carolina 
cassidy: cassidy 
louisiana: louisiana 
forward: forward 
short: short 
disappointed: disappointed 
certain: certain 
responded: responded 
approval: approval 
expanding: expanding 
insurance: insurance 
product: products 
le: less 
comprehensive: comprehensive 
association: associations association 
small: small 
employer: employer employers 
coverage: coverage 
get: get 
rid: rid 
subsidy: subsidies 
sharing: sharing 
reduction: reduction 
payment: payment payments 
deductible: deductibles 
low: low 
expected: expected 
next: next 
mandate: mandate 
rollback: rollback 
cover: cover 
copayments: copayments 
preventive: preventive 
threatened: threatened 
religious: religious 
applied: applied 
object: objects object 
covering: covering 
contraception: contraception 
basis: basis 
sincerely: sincerely 
belief: beliefs belief 
moral: moral 
conviction: convictions 
line: lines line 
ensure: ensure 
bullied: bullied 
opponent: opponents opponent 
measure: measure measures 
potentially: potentially 
affect: affect 
hundred: hundreds 
thousand: thousands 
provided: provided 
prevents: prevents 
unintended: unintended 
pregnancy: pregnancy pregnancies 
save: saves 
strongly: strongly 
pro: pro 
except: except 
rape: rape 
incest: incest 
danger: danger 
supported: supported 
cited: cited 
law: law laws 
restrictive: restrictive 
changed: changed 
anti: anti 
punishment: punishment 
undergo: undergo 
thought: thought 
practitioner: practitioners 
punished: punished 
performing: performing 
california: california 
sitting: sitting 
address: address 
annual: annual 
rally: rally rallies 
outline: outline 
dramatically: dramatically 
code: codes 
streamlining: streamlining 
seven: seven 
bracket: brackets 
percent: percent 
initial: initial 
specify: specify 
range: ranges range 
rate: rate 
eliminate: eliminate 
simplify: simplify 
process: process 
filing: filing 
proposal: proposals proposal 
might: might 
increase: increase 
achieved: achieved 
sweeping: sweeping 
approved: approved 
criticism: criticism 
extensive: extensive 
last: last 
minute: minute minutes 
rewrite: rewrites 
frustrated: frustrated 
posting: posting 
crossed: crossed 
text: text 
handwriting: handwriting 
crammed: crammed 
slashing: slashing 
doubling: doubling 
deduction: deductions 
ending: ending 
provision: provision 
allowed: allowed 
unborn: unborn 
beneficiary: beneficiaries 
saving: savings 
account: account accounts 
attempt: attempt attempts 
estimate: estimates 
trillion: trillion 
gop: gop 
insisted: insisted 
offset: offset 
growing: growing 
passage: passage 
biggest: biggest 
thank: thank 
commitment: commitment commitments 
formally: formally 
chamber: chamber chambers 
resulted: resulted 
brief: brief 
shutdown: shutdown 
stopgap: stopgap 
torpedo: torpedo 
veto: veto 
angry: angry 
fully: fully 
long: long 
nevertheless: nevertheless 
hour: hours 
gone: gone 
effect: effect 
transgender: transgender 
rolled: rolled 
bathroom: bathrooms 
correspond: correspond 
gender: gender 
identity: identity 
allowing: allowing 
interpret: interpret 
review: reviews review 
reverse: reverse 
blacklisting: blacklisting 
rule: rules rule 
requiring: requiring 
contractor: contractors contractor 
disclose: disclose 
labor: labor 
wage: wage 
workplace: workplace 
safety: safety 
enact: enact 
person: person persons 
diagnosis: diagnosis 
dysphoria: dysphoria 
require: require 
substantial: substantial 
treatment: treatment 
medication: medications 
surgery: surgery 
disqualified: disqualified 
limited: limited 
circumstance: circumstances 
go: go 
additional: additional 
ownership: ownership 
spoke: spoke 
rifle: rifles rifle 
strengthen: strengthen 
background: background 
check: check checks 
willing: willing 
consider: consider 
restrict: restrict 
banned: banned 
bump: bump 
stock: stocks 
mass: mass 
shooting: shooting shootings 
la: las 
vega: vegas 
music: music 
festival: festival 
dead: dead 
valentine: valentine 
marjory: marjory 
stoneman: stoneman 
douglas: douglas 
high: high 
parkland: parkland 
total: total 
faculty: faculty 
sparked: sparked 
response: response responses 
banning: banning 
strengthening: strengthening 
buying: buying 
backed: backed 
nra: nra 
fueled: fueled 
arming: arming 
teacher: teachers 
backlash: backlash 
profession: profession 
invested: invested 
even: even 
usual: usual 
cycle: cycle 
outrage: outrage 
diminishing: diminishing 
televised: televised 
meeting: meeting 
lawmaker: lawmakers 
expand: expand 
show: show shows 
internet: internet 
transaction: transactions 
secure: secure 
young: young 
adult: adults adult 
point: point 
pat: pat 
toomey: toomey 
afraid: afraid 
authority: authorities authority 
seize: seize 
mentally: mentally 
ill: ill 
dangerous: dangerous 
due: due 
seemingly: seemingly 
stunned: stunned 
within: within 
walking: walking 
raise: raise 
limit: limit limits 
mainly: mainly 
pushing: pushing 
select: select 
silencer: silencers 
dozen: dozen dozens 
killed: killed 
gunman: gunman 
virginia: virginia 
beach: beach 
municipal: municipal 
el: el 
paso: paso 
texas: texas 
dayton: dayton 
ohio: ohio 
tying: tying 
expanded: expanded 
give: gives give 
thumb: thumbs 
quicken: quicken 
arena: arena 
chip: chip 
somodevilla: somodevilla 
funded: funded 
taxpayer: taxpayers taxpayer 
dollar: dollars 
reimburse: reimburse 
negotiated: negotiated 
import: import imports 
enrique: enrique 
pe: pe 
xf: xf 
nieto: nieto 
canceled: canceled 
visit: visit 
meet: meet 
materialize: materialize 
either: either 
reinforce: reinforce 
using: using 
troop: troops 
horrible: horrible 
unsafe: unsafe 
vulnerable: vulnerable 
proclamation: proclamation 
directed: directed 
guard: guard 
homeland: homeland 
deployment: deployment 
coordination: coordination 
governor: governors 
personnel: personnel 
custom: customs 
direct: direct 
shortly: shortly 
newly: newly 
set: set 
unless: unless 
allocated: allocated 
demand: demand 
partial: partial 
ensued: ensued 
striking: striking 
compromise: compromise 
deadline: deadline 
package: package 
mile: miles 
steel: steel 
post: post posts 
fencing: fencing 
indicating: indicating 
threat: threats threat 
declare: declare 
emergency: emergency 
enabling: enabling 
funnel: funnel 
slated: slated 
project: projects 
coalition: coalition 
challenged: challenged 
circumvent: circumvent 
contrary: contrary 
pretext: pretext 
manufactured: manufactured 
unlawful: unlawful 
redirect: redirect 
appropriated: appropriated 
interdiction: interdiction 
initiative: initiatives 
overturn: overturn 
declaration: declaration 
promptly: promptly 
overturned: overturned 
appellate: appellate 
ruled: ruled 
begin: begin 
pentagon: pentagon 
ongoing: ongoing 
litigation: litigation 
separation: separation 
seal: seal 
zero: zero 
tolerance: tolerance 
prosecute: prosecute 
anybody: anybody 
illegally: illegally 
legally: legally 
detained: detained 
meant: meant 
separately: separately 
wound: wound 
furor: furor 
surfaced: surfaced 
separated: separated 
period: period 
compounded: compounded 
toddler: toddlers 
cry: crying 
cage: cages 
initially: initially 
deflected: deflected 
blame: blame 
insisting: insisting 
predecessor: predecessors predecessor 
forcing: forcing 
breakup: breakup 
cruel: cruel 
caved: caved 
pressure: pressure 
bad: bad 
pr: pr 
sight: sight 
feeling: feeling 
adding: adding 
enter: enter 
find: find 
permanent: permanent 
solution: solution 
problem: problem 
meantime: meantime 
dhs: dhs 
essentially: essentially 
catch: catch 
eradicate: eradicate 
dealing: dealing dealings 
logistics: logistics 
reuniting: reuniting 
vetting: vetting 
radical: radical 
islamic: islamic 
terrorist: terrorists 
refugee: refugees 
traveling: traveling 
airport: airports 
iraq: iraq 
iran: iran 
sudan: sudan 
libya: libya 
somalia: somalia 
yemen: yemen 
suspended: suspended 
entry: entry 
barred: barred 
syrian: syrians syrian 
indefinitely: indefinitely 
christian: christian 
network: networks network 
priority: priority 
trying: trying 
gain: gain 
facing: facing 
hurdle: hurdles 
revised: revised 
traveler: travelers 
original: original 
removed: removed 
listed: listed 
hold: hold 
green: green 
card: cards card 
valid: valid 
visa: visas 
signing: signing 
affected: affected 
minority: minorities minority 
special: special 
preference: preference 
indefinite: indefinite 
reduced: reduced 
derrick: derrick 
watson: watson 
hawaii: hawaii 
temporary: temporary 
nationwide: nationwide 
restraining: restraining 
ruling: ruling 
stated: stated 
protect: protect 
disfavor: disfavor 
particular: particular 
religion: religion 
spite: spite 
religiously: religiously 
neutral: neutral 
nashville: nashville 
opinion: opinion 
unprecedented: unprecedented 
judicial: judicial 
overreach: overreach 
theodore: theodore 
chuang: chuang 
maryland: maryland 
blocked: blocked 
subsequent: subsequent 
impeded: impeded 
handed: handed 
richmond: richmond 
ninth: ninth 
lacked: lacked 
bona: bona 
fide: fide 
relationship: relationship 
entity: entity 
oral: oral 
timeline: timeline 
conduct: conduct 
rendered: rendered 
moot: moot 
permanently: permanently 
chad: chad 
korea: korea 
venezuela: venezuela 
tweak: tweak 
little: little 
pacify: pacify 
argued: argued 
still: still 
heavily: heavily 
biased: biased 
islam: islam 
added: added 
visitor: visitors 
obfuscate: obfuscate 
romero: romero 
director: director 
union: union 
freezing: freezing 
writing: writing 
poor: poor 
fit: fits fit 
regarding: regarding 
version: version 
urged: urged 
lawful: lawful 
enforce: enforce 
restriction: restrictions 
eight: eight 
unable: unable 
emigrate: emigrate 
studying: studying 
vacationing: vacationing 
upheld: upheld 
judgment: judgments 
realm: realm 
regardless: regardless 
sharply: sharply 
worded: worded 
dissent: dissent 
sonia: sonia 
sotomayor: sotomayor 
outcome: outcome 
equivalent: equivalent 
korematsu: korematsu 
permitted: permitted 
detention: detention 
japanese: japanese 
ii: ii 
weed: weed 
assistance: assistance 
dependent: dependent 
food: food 
stamp: stamps 
benefit: benefits benefit 
tightened: tightened 
requirement: requirements 
seeking: seeking 
resident: residents 
focusing: focusing 
factor: factors 
asset: assets 
status: status 
weapon: weapons 
sanction: sanctions 
intelligence: intelligence 
expert: experts expert 
produced: produced 
miniaturized: miniaturized 
warhead: warhead warheads 
inside: inside 
missile: missiles missile 
putting: putting 
closer: closer 
becoming: becoming 
korean: korean 
examining: examining 
operational: operational 
strike: strikes strike 
area: areas area 
territory: territory 
guam: guam 
strategic: strategic 
ballistic: ballistic 
intercontinental: intercontinental 
capable: capable 
reaching: reaching 
fire: fire 
fury: fury 
locked: locked 
loaded: loaded 
kim: kim 
jong: jong 
un: un 
watch: watch 
foolish: foolish 
stupid: stupid 
yankee: yankees 
wise: wise 
reasoned: reasoned 
warned: warned 
risking: risking 
uncontrollable: uncontrollable 
phase: phase 
drill: drills 
japan: japan 
pejoratively: pejoratively 
rocketman: rocketman 
totally: totally 
destroy: destroy 
ally: allies ally 
widened: widened 
shoot: shoot 
airplane: airplanes 
airspace: airspace 
rex: rex 
tillerson: tillerson 
communication: communication communications 
looking: looking 
militarized: militarized 
path: path 
cia: cia 
mike: mike 
pompeo: pompeo 
able: able 
mainland: mainland 
react: react 
accordingly: accordingly 
concerned: concerned 
increasingly: increasingly 
read: read 
bella: bella 
hadid: hadid 
sadie: sadie 
alexander: alexander 
adrienne: adrienne 
summit: summits summit 
winter: winter 
olympics: olympics 
pyeongchang: pyeongchang 
unity: unity 
relayed: relayed 
leaped: leaped 
opportunity: opportunity 
announcing: announcing 
secluded: secluded 
capella: capella 
resort: resort 
singapore: singapore 
marking: marking 
encounter: encounter 
talk: talks talk 
interpreter: interpreters 
top: top 
staffer: staffers 
bolton: bolton 
staff: staff 
kelly: kelly 
afterward: afterward 
ceremony: ceremony 
committed: committed 
provide: provide 
guarantee: guarantees 
reaffirmed: reaffirmed 
unwavering: unwavering 
complete: complete 
denuclearization: denuclearization 
peninsula: peninsula 
marked: marked 
diplomatic: diplomatic 
predicted: predicted 
proud: proud 
whole: whole 
different: different 
metropole: metropole 
hanoi: hanoi 
discus: discuss 
counterpart: counterpart 
tremendous: tremendous 
look: look looks 
watching: watching 
happen: happen 
abruptly: abruptly 
asked: asked 
lifted: lifted 
exchange: exchange 
dismantling: dismantling 
facility: facility facilities 
element: elements 
sometimes: sometimes 
walk: walk 
concluded: concluded 
foot: foot 
informal: informal 
discussion: discussions 
demilitarized: demilitarized 
zone: zone 
designate: designate 
negotiator: negotiators 
resume: resume 
coming: coming 
speaking: speaking 
winnacunnet: winnacunnet 
hampton: hampton 
hampshire: hampshire 
rick: rick 
friedman: friedman 
rickfriedman: rickfriedman 
com: com 
corbis: corbis 
russia: russia 
russian: russians russian 
hacking: hacking 
throughout: throughout 
vehemently: vehemently 
allegation: allegations allegation 
vladimir: vladimir 
putin: putin 
tied: tied 
dnc: dnc 
email: emails email 
prepared: prepared 
fbi: fbi 
nsa: nsa 
influence: influence 
goal: goals 
undermine: undermine 
faith: faith 
denigrate: denigrate 
harm: harm 
electability: electability 
ass: assess 
developed: developed 
clear: clear 
elect: elect 
prior: prior 
cast: cast 
doubt: doubts doubt 
interference: interference 
briefing: briefing 
press: press 
conference: conference 
acknowledged: acknowledged 
refused: refused 
condemn: condemn 
notably: notably 
occasion: occasions 
denial: denials denial 
issuing: issuing 
alleged: alleged 
cyberattacks: cyberattacks 
steven: steven 
delivered: delivered 
announcement: announcement 
remaining: remaining 
silent: silent 
finland: finland 
deputy: deputy 
rod: rod 
rosenstein: rosenstein 
officer: officers 
formal: formal 
helsinki: helsinki 
heel: heels 
scrutinized: scrutinized 
nato: nato 
indictment: indictments indictment 
operative: operatives 
interfering: interfering 
prompted: prompted 
finger: finger 
extremely: extremely 
powerful: powerful 
harsh: harsh 
stateside: stateside 
notable: notable 
joining: joining 
colleague: colleagues 
siding: siding 
mccain: mccain 
disgraceful: disgraceful 
performance: performances 
memory: memory 
newt: newt 
gingrich: gingrich 
weighed: weighed 
tweeting: tweeting 
serious: serious 
mistake: mistake 
must: must 
corrected: corrected 
sought: sought 
quiet: quiet 
returning: returning 
misspoken: misspoken 
see: see 
blamed: blamed 
reminding: reminding 
numerous: numerous 
noted: noted 
finding: finding findings 
attempted: attempted 
interfere: interfere 
revealed: revealed 
instructed: instructed 
invite: invite 
autumn: autumn 
caught: caught 
dan: dan 
coat: coats 
disclosed: disclosed 
postpone: postpone 
invitation: invitation 
conclusion: conclusion 
counsel: counsel 
meddling: meddling 
overture: overtures 
suspension: suspension 
intermediate: intermediate 
force: forces force 
treaty: treaty 
eastern: eastern 
repeated: repeated 
comply: comply 
completed: completed 
opposition: opposition 
airfield: airfield 
chemical: chemical 
attack: attacks attack 
bashar: bashar 
al: al 
assad: assad 
civilian: civilians civilian 
horrific: horrific 
navy: navy 
destroyer: destroyers 
fired: fired 
tomahawk: tomahawk 
shayrat: shayrat 
evidence: evidence 
rebel: rebel 
douma: douma 
referred: referred 
perpetrated: perpetrated 
vow: vows 
ready: ready 
killing: killing 
animal: animal 
kill: kills 
enjoys: enjoys 
subsequently: subsequently 
france: france 
coordinated: coordinated 
larger: larger 
operation: operation 
scientific: scientific 
declaring: declaring 
mission: mission 
accomplished: accomplished 
pulled: pulled 
changing: changing 
mind: mind 
denounced: denounced 
primarily: primarily 
reversed: reversed 
ordering: ordering 
northeast: northeast 
turkish: turkish 
threaten: threaten 
kurdish: kurdish 
insurgent: insurgents 
drawing: drawing 
sharp: sharp 
arguing: arguing 
let: let 
region: region 
figure: figure 
respond: respond 
forcefully: forcefully 
turkey: turkey 
anything: anything 
imposing: imposing 
offensive: offensive 
endangering: endangering 
threatening: threatening 
peace: peace 
stability: stability 
angerer: angerer 
abu: abu 
bakr: bakr 
baghdadi: baghdadi 
daring: daring 
commando: commando 
raid: raid 
militant: militant 
chased: chased 
underground: underground 
tunnel: tunnel 
whimpering: whimpering 
screaming: screaming 
detonating: detonating 
suicide: suicide 
vest: vest 
amid: amid 
pointing: pointing 
presence: presence 
contribution: contributions 
success: success 
commerce: commerce 
tariff: tariff tariffs 
aluminum: aluminum 
granted: granted 
restrain: restrain 
metal: metal 
export: exports 
china: china 
stalled: stalled 
moving: moving 
retaliatory: retaliatory 
canadian: canadian 
prime: prime 
minister: minister 
justin: justin 
trudeau: trudeau 
condemning: condemning 
unacceptable: unacceptable 
french: french 
emmanuel: emmanuel 
macron: macron 
isolate: isolate 
frosty: frosty 
reception: reception 
g: g 
quebec: quebec 
making: making 
communique: communique 
shot: shot shots 
brussels: brussels 
belgium: belgium 
germany: germany 
captive: captive 
dependence: dependence 
natural: natural 
k: k 
theresa: theresa 
handling: handling 
brexit: brexit 
head: head 
fallout: fallout 
costly: costly 
relief: relief 
farmer: farmers 
detail: details 
aid: aid 
struggling: struggling 
chinese: chinese 
penalize: penalize 
negotiate: negotiate 
moved: moved 
escalated: escalated 
ahead: ahead 
attempting: attempting 
hammer: hammer 
obtain: obtain 
taxed: taxed 
continue: continue 
stall: stall 
hike: hike 
agreeing: agreeing 
latter: latter 
encompassing: encompassing 
gushed: gushed 
reached: reached 
intellectual: intellectual 
property: property 
agriculture: agriculture 
mid: mid 
purchase: purchase 
refrain: refrain 
currency: currency 
manipulation: manipulation 
theft: theft 
taiwan: taiwan 
selling: selling 
tank: tanks 
equipment: equipment 
largest: largest 
recent: recent 
tension: tension tensions 
supplier: supplier 
arm: arms 
help: help 
stave: stave 
eventual: eventual 
invasion: invasion 
officially: officially 
recognize: recognize 
de: de 
facto: facto 
communist: communist 
bring: bring 
counterweight: counterweight 
expressed: expressed 
ire: ire 
naval: naval 
ship: ships 
sail: sail 
strait: strait 
israel: israel 
recognition: recognition 
jerusalem: jerusalem 
recognizing: recognizing 
capital: capital 
embassy: embassy 
location: location 
tel: tel 
aviv: aviv 
broke: broke 
precedent: precedent 
israeli: israelis israeli 
palestinian: palestinian palestinians 
territorial: territorial 
fulfilling: fulfilling 
overdue: overdue 
noting: noting 
folly: folly 
assume: assume 
repeating: repeating 
exact: exact 
formula: formula 
produce: produce 
stressed: stressed 
praised: praised 
benjamin: benjamin 
netanyahu: netanyahu 
warmly: warmly 
disruptive: disruptive 
saudi: saudi 
arabia: arabia 
jordan: jordan 
egypt: egypt 
lebanon: lebanon 
condemned: condemned 
mahmoud: mahmoud 
abbas: abbas 
longer: longer 
mediator: mediator 
others: others 
australia: australia 
abstained: abstained 
dispatching: dispatching 
penny: pence 
smooth: smooth 
arab: arab 
east: east 
reestablish: reestablish 
tie: ties 
forum: forum 
davos: davos 
switzerland: switzerland 
enjoyed: enjoyed 
friendly: friendly 
continuing: continuing 
recalibrated: recalibrated 
approach: approach 
relation: relations 
west: west 
bank: bank 
international: international 
bolster: bolster 
jew: jews 
cracking: cracking 
semitism: semitism 
campus: campuses 
effectively: effectively 
judaism: judaism 
nationality: nationality 
empowering: empowering 
withhold: withhold 
educational: educational 
discriminatory: discriminatory 
envisioned: envisioned 
getting: getting 
annexing: annexing 
dismissing: dismissing 
slap: slap 
presided: presided 
bahrain: bahrain 
emirate: emirates 
normalized: normalized 
objection: objections 
withdrawing: withdrawing 
enacted: enacted 
reimposing: reimposing 
tepid: tepid 
hassan: hassan 
rouhani: rouhani 
stronger: stronger 
diplomat: diplomats 
warning: warning 
play: play 
lion: lion 
tail: tail 
regret: regret 
eternally: eternally 
enraged: enraged 
cap: caps 
tweet: tweets tweet 
addressed: addressed 
suffer: suffer 
consequence: consequences 
stand: stand 
demented: demented 
cautious: cautious 
mounted: mounted 
india: india 
buy: buy 
tanker: tankers 
attacked: attacked 
near: near 
hormuz: hormuz 
holding: holding 
brazen: brazen 
iranian: iranian 
drone: drone 
contested: contested 
retaliation: retaliation 
electing: electing 
impose: impose 
instead: instead 
rocket: rocket 
iraqi: iraqi 
carried: carried 
militia: militia 
deemed: deemed 
breaching: breaching 
outer: outer 
animosity: animosity 
qassem: qassem 
soleimani: soleimani 
commander: commander 
cuba: cuba 
venezuelan: venezuelan 
nicolas: nicolas 
maduro: maduro 
tourist: tourist 
applying: applying 
curtailing: curtailing 
loosened: loosened 
detente: detente 
initiating: initiating 
lived: lived 
charlottesville: charlottesville 
nationalist: nationalists 
virgina: virgina 
gathered: gathered 
unite: unite 
removal: removal 
statue: statue 
confederate: confederate 
lee: lee 
favor: favor 
removing: removing 
symbol: symbol 
implicitly: implicitly 
endorsing: endorsing 
supremacy: supremacy 
erasing: erasing 
attracted: attracted 
ku: ku 
klux: klux 
klan: klan 
neo: neo 
nazi: nazis 
kkk: kkk 
david: david 
duke: duke 
fulfill: fulfill 
counter: counter 
arrived: arrived 
demonstration: demonstration 
violent: violent 
racial: racial 
slur: slurs 
brawling: brawling 
car: car 
driven: driven 
appeared: appeared 
marching: marching 
earlier: earlier 
alongside: alongside 
cnn: cnn 
plowed: plowed 
injuring: injuring 
specifically: specifically 
criticize: criticize 
hatred: hatred 
bigotry: bigotry 
refusal: refusal 
denounce: denounce 
hate: hate 
racism: racism 
evil: evil 
cause: cause 
criminal: criminals criminal 
thug: thugs 
supremacist: supremacists 
repugnant: repugnant 
everything: everything 
dear: dear 
kevin: kevin 
plank: plank 
armour: armour 
kenneth: kenneth 
frazier: frazier 
african: african 
merck: merck 
pharmaceutical: pharmaceuticals 
resigning: resigning 
manufacturing: manufacturing 
council: council 
reaction: reaction 
event: events event 
ken: ken 
pharma: pharma 
resigned: resigned 
ripoff: ripoff 
price: prices 
telling: telling 
sen: sen 
tim: tim 
especially: especially 
light: light 
advent: advent 
antifa: antifa 
pretty: pretty 
dude: dudes 
fascist: fascist 
us: uses 
tactic: tactics 
birther: birther 
validity: validity 
outlet: outlets 
quell: quell 
staunch: staunch 
outcry: outcry 
birtherists: birtherists 
certificate: certificate 
verifying: verifying 
vocal: vocal 
hawaiian: hawaiian 
cardiac: cardiac 
arrhythmia: arrhythmia 
plane: plane 
crash: crash 
somehow: somehow 
connected: connected 
clinch: clinch 
toned: toned 
theory: theory 
someday: someday 
write: write 
advisor: advisors 
conspiracy: conspiracy 
rest: rest 
strategy: strategy 
barack: barack 
rival: rival 
starting: starting 
wiretapping: wiretapping 
citing: citing 
specific: specific 
accusing: accusing 
headquarters: headquarters 
comey: comey 
refuting: refuting 
claim: claim claims 
bipartisan: bipartisan 
wiretapped: wiretapped 
looked: looked 
carefully: carefully 
investigating: investigating 
link: links 
associated: associated 
midst: midst 
leading: leading 
colluded: colluded 
recommendation: recommendations recommendation 
session: session sessions 
server: server 
shockwaves: shockwaves 
comparing: comparing 
dismissal: dismissal 
saturday: saturday 
night: night 
massacre: massacre 
archibald: archibald 
cox: cox 
prosecutor: prosecutors prosecutor 
watergate: watergate 
resignation: resignation 
schumer: schumer 
rightly: rightly 
suspect: suspect 
lester: lester 
holt: holt 
solely: solely 
firing: firing 
shut: shut 
flynn: flynn 
memo: memo 
hope: hope 
letting: letting 
guy: guy 
anticipated: anticipated 
appearance: appearance 
lying: lying 
nature: nature 
tenure: tenure 
probe: probe 
remark: remarks 
pardoning: pardoning 
thanksgiving: thanksgiving 
federation: federation 
carl: carl 
wittenburg: wittenburg 
rose: rose 
garden: garden 
mueller: mueller 
selected: selected 
serve: serve 
lead: lead 
closed: closed 
submitting: submitting 
barr: barr 
ag: ag 
summarized: summarized 
letter: letter 
collusion: collusion 
agent: agents 
wording: wording 
obstructed: obstructed 
conclude: conclude 
exonerate: exonerate 
nonetheless: nonetheless 
exoneration: exoneration 
disparaging: disparaging 
takedown: takedown 
ensnaring: ensnaring 
manafort: manafort 
associate: associate 
gate: gates 
laundering: laundering 
pleaded: pleaded 
guilty: guilty 
count: count 
cooperating: cooperating 
inquire: inquire 
topic: topics 
welcomed: welcomed 
idea: idea 
backing: backing 
protested: protested 
warrant: warrant 
wiretap: wiretap 
carter: carter 
doj: doj 
relied: relied 
infamous: infamous 
dossier: dossier 
whose: whose 
author: author 
commissioned: commissioned 
dig: dig 
dirt: dirt 
seem: seem 
thereby: thereby 
discrediting: discrediting 
bureau: bureau 
involvement: involvement 
obtained: obtained 
hoped: hoped 
ask: ask 
understanding: understanding 
conducted: conducted 
oldest: oldest 
intention: intentions 
behind: behind 
obstruction: obstruction 
sat: sat 
face: face 
questioning: questioning 
written: written 
obtuse: obtuse 
language: language 
die: die 
particularly: particularly 
redacted: redacted 
shield: shield 
exerted: exerted 
privilege: privilege 
unredacted: unredacted 
recommend: recommend 
contempt: contempt 
stormy: stormy 
daniel: daniels 
stephanie: stephanie 
clifford: clifford 
stage: stage 
nondisclosure: nondisclosure 
remain: remain 
street: street 
journal: journal 
saga: saga 
jimmy: jimmy 
kimmel: kimmel 
coy: coy 
longtime: longtime 
cohen: cohen 
paying: paying 
pocket: pocket 
say: say says 
silence: silence 
invalid: invalid 
described: described 
tryst: tryst 
parking: parking 
lot: lot 
unknown: unknown 
discussing: discussing 
piece: piece 
aired: aired 
mistress: mistress 
playboy: playboy 
karen: karen 
mcdougal: mcdougal 
fallen: fallen 
aboard: aboard 
air: air 
knew: knew 
compelled: compelled 
shell: shell 
inc: inc 
ami: ami 
speak: speak 
freely: freely 
enquirer: enquirer 
exclusive: exclusive 
story: story stories 
tabloid: tabloid 
licensed: licensed 
defamation: defamation 
composite: composite 
sketch: sketch 
allegedly: allegedly 
confronted: confronted 
con: con 
claimed: claimed 
recklessly: recklessly 
liar: liar 
breaking: breaking 
southern: southern 
secret: secret 
recording: recording 
conversation: conversation 
aware: aware 
magnified: magnified 
plead: plead 
instigation: instigation 
violate: violate 
hush: hush 
sentenced: sentenced 
prison: prison 
testify: testify 
array: array 
infraction: infractions 
ex: ex 
bos: boss 
wikileaks: wikileaks 
dump: dump 
supplied: supplied 
reimbursement: reimbursement 
collection: collection 
donor: donors 
vendor: vendors 
grew: grew 
defraud: defraud 
jean: jean 
carroll: carroll 
journalist: journalist journalists 
sexually: sexually 
assaulting: assaulting 
upscale: upscale 
store: store 
bergdorf: bergdorf 
goodman: goodman 
approached: approached 
leaving: leaving 
female: female 
friend: friend 
upstairs: upstairs 
lingerie: lingerie 
bit: bit 
banter: banter 
pinned: pinned 
dressing: dressing 
room: room 
tights: tights 
assaulted: assaulted 
lisa: lisa 
birnbach: birnbach 
describe: describe 
raped: raped 
police: police 
carol: carol 
martin: martin 
advised: advised 
excerpt: excerpt 
magazine: magazine 
article: article articles 
photograph: photograph 
shaking: shaking 
fiction: fiction 
sell: sell 
hollywood: hollywood 
embroiled: embroiled 
lewdly: lewdly 
kissing: kissing 
groping: groping 
sex: sex 
nancy: nancy 
dell: dell 
captured: captured 
billy: billy 
anchor: anchor 
soap: soap 
opera: opera 
arianne: arianne 
zucker: zucker 
segment: segment 
gotta: gotta 
tic: tic 
tacs: tacs 
start: start 
microphone: microphone microphones 
automatically: automatically 
beautiful: beautiful 
magnet: magnet 
kiss: kiss 
wait: wait 
grab: grab 
genitals: genitals 
locker: locker 
ago: ago 
far: far 
worse: worse 
apologize: apologize 
anyone: anyone 
offended: offended 
posted: posted 
videotaped: videotaped 
apology: apology 
facebook: facebook 
perfect: perfect 
pretended: pretended 
someone: someone 
done: done 
reflect: reflect 
wrong: wrong 
immediate: immediate 
ayotte: ayotte 
crapo: crapo 
shelley: shelley 
moore: moore 
capito: capito 
martha: martha 
roby: roby 
fellow: fellow 
condoleezza: condoleezza 
rice: rice 
defiant: defiant 
stay: stay 
leak: leak 
experience: experiences 
harassed: harassed 
pressuring: pressuring 
ukraine: ukraine 
whistleblower: whistleblower 
withholding: withholding 
phone: phone 
ukrainian: ukrainian 
volodymyr: volodymyr 
zelensky: zelensky 
investigate: investigate 
hunter: hunter 
acting: acting 
joseph: joseph 
maguire: maguire 
relay: relay 
transcript: transcript 
withheld: withheld 
digging: digging 
doubled: doubled 
assertion: assertion 
bidens: bidens 
needed: needed 
investigated: investigated 
unidentified: unidentified 
knowledge: knowledge 
b: b 
taylor: taylor 
ambassador: ambassador 
defied: defied 
recollection: recollection 
investigator: investigators 
corroborate: corroborate 
quid: quid 
quo: quo 
vindman: vindman 
jeopardize: jeopardize 
acquittal: acquittal 
initiation: initiation 
proceeding: proceedings 
hopeful: hopefuls 
kamala: kamala 
harris: harris 
cory: cory 
booker: booker 
declined: declined 
pursue: pursue 
decide: decide 
impeachable: impeachable 
offense: offenses 
chair: chair 
jerry: jerry 
nadler: nadler 
pelosi: pelosi 
pursuing: pursuing 
congresswoman: congresswomen 
color: color 
launch: launch 
yet: yet 
plunge: plunge 
defeated: defeated 
tide: tide 
conceal: conceal 
launching: launching 
inquiry: inquiry 
approve: approve 
established: established 
lone: lone 
unanimous: unanimous 
commenced: commenced 
busy: busy 
recep: recep 
tayyip: tayyip 
erdogan: erdogan 
gordon: gordon 
sondland: sondland 
charging: charging 
abuse: abuses abuse 
entirely: entirely 
impeached: impeached 
andrew: andrew 
johnson: johnson 
manager: managers 
defense: defense 
lurked: lurked 
wild: wild 
upcoming: upcoming 
irrelevant: irrelevant 
witness: witnesses 
acquit: acquit 
utah: utah 
convict: convict 
coronavirus: coronavirus 
lap: lap 
beating: beating 
emergence: emergence 
novel: novel 
outbreak: outbreak 
reflection: reflection 
dire: dire 
patient: patient 
recorded: recorded 
risk: risk 
remains: remains 
reassurance: reassurances 
escalate: escalate 
pandemic: pandemic 
league: leagues 
season: seasons 
drop: drop 
black: black 
monday: monday 
free: free 
sick: sick 
leave: leave 
worker: workers 
unemployment: unemployment 
diagnostic: diagnostic 
testing: testing 
lending: lending 
hospital: hospital hospitals 
suspending: suspending 
severely: severely 
mismanaging: mismanaging 
spread: spread 
issuance: issuance 
clashed: clashed 
dr: dr 
fauci: fauci 
institute: institute 
allergy: allergy 
infectious: infectious 
disease: diseases 
niaid: niaid 
reel: reel 
reopening: reopening 
safely: safely 
welcome: welcome 
decried: decried 
analysis: analysis 
acceptable: acceptable 
answer: answer 
tested: tested 
covid: covid 
walter: walter 
reed: reed 
fatigued: fatigued 
physician: physician 
negative: negative 
test: test 
frequent: frequent 
retweeting: retweeting 
msnbc: msnbc 
scarborough: scarborough 
mail: mail 
voting: voting 
widespread: widespread 
add: add 
checking: checking 
censor: censor 
section: section 
decency: decency 
cda: cda 
remove: remove 
statutory: statutory 
tech: tech 
engage: engage 
censorship: censorship 
patented: patented 
seat: seat 
amway: amway 
orlando: orlando 
extolling: extolling 
whipped: whipped 
frenzy: frenzy 
lashing: lashing 
witch: witch 
hunt: hunt 
enemy: enemies 
slogan: slogan 
fighting: fighting 
winning: winning 
challenger: challenger 
largely: largely 
criticized: criticized 
chaotic: chaotic 
talking: talking 
moderator: moderator 
chris: chris 
wallace: wallace 
commanded: commanded 
chided: chided 
denunciation: denunciation 
extremist: extremist 
scheduled: scheduled 
virtual: virtual 
town: town 
hall: halls 
often: often 
muted: muted 
prevent: prevent 
interruption: interruptions 
restrained: restrained 
depicted: depicted 
touted: touted 
progress: progress 
maintained: maintained 
defeat: defeat 
heading: heading 
solid: solid 
footing: footing 
crucial: crucial 
jumped: jumped 
battleground: battleground 
tipping: tipping 
ballot: ballots 
gradually: gradually 
lash: lash 
michigan: michigan 
nevada: nevada 
georgia: georgia 
lose: lose 
h: h 
concede: concede 
elector: electors 
formalizing: formalizing 
gaining: gaining 
traction: traction 
brad: brad 
raffensperger: raffensperger 
overcome: overcome 
deficit: deficit 
additionally: additionally 
loyal: loyal 
certification: certification 
ratcheted: ratcheted 
capitol: capitol 
siege: siege 
exhorted: exhorted 
nearby: nearby 
stormed: stormed 
fought: fought 
evacuated: evacuated 
sacred: sacred 
landslide: landslide 
unceremoniously: unceremoniously 
viciously: viciously 
stripped: stripped 
patriot: patriots 
badly: badly 
unfairly: unfairly 
treated: treated 
remember: remember 
forever: forever 
reclaimed: reclaimed 
complex: complex 
p: p 
chaos: chaos 
arrest: arrests 
mayor: mayor 
muriel: muriel 
bowser: bowser 
reconvened: reconvened 
midnight: midnight 
voicing: voicing 
winner: winner 
riot: riots 
disagree: disagree 
bear: bear 
orderly: orderly 
transition: transition 
twiter: twiter 
heinous: heinous 
conceded: conceded 
emotion: emotions 
temper: tempers 
cooled: cooled 
calm: calm 
certified: certified 
inaugurated: inaugurated 
focus: focus 
turn: turns 
ensuring: ensuring 
seamless: seamless 
moment: moment 
healing: healing 
reconciliation: reconciliation 
attend: attend 
instagram: instagram 
impeach: impeach 
incitement: incitement 
insurrection: insurrection 
twice: twice 
acquitted: acquitted 
farewell: farewell 
true: true 
outsider: outsider 
politician: politician 
open: open 
skyline: skylines 
imagining: imagining 
infinite: infinite 
possibility: possibilities 
towering: towering 
waiting: waiting 
scaled: scaled 
boundless: boundless 
stepped: stepped 
difficult: difficult 
sort: sorts 
properly: properly 
given: given 
wanted: wanted 
something: something 
strive: strive 
accuracy: accuracy 
fairness: fairness 
citation: citation 
title: title 
editor: editors 
website: website 
url: url 
publisher: publisher 
updated: updated 
receive: receive 
shaped: shaped 
served: served 
founder: founder 
trustee: trustee 
businessman: businessman 
glover: glover 
creator: creator 
comedy: comedy 
atlanta: atlanta 
rap: raps 
childish: childish 
gambino: gambino 
sutherland: sutherland 
actor: actor 
movie: movies 
dirty: dirty 
pride: pride 
prejudice: prejudice 
hunger: hunger 
game: games 
loading: loading 
logo: logo 
trademark: trademarks 
llc: llc 
