body: body 
margin: margin 
top: top 
important: important 
padding: padding 
min: min 
width: width 
px: px 
wm: wm 
rw: rw 
iframe: iframe 
id: id 
donato: donato 
src: src 
platform: platform 
wb: wb 
referer: referer 
web: web 
archive: archive 
org: org 
www: www 
python: python 
download: download 
release: releases 
highlight: highlights 
scrolling: scrolling 
frameborder: frameborder 
style: style 
height: height 
capture: capture captures 
jun: jun 
feb: feb 
aug: aug 
oct: oct 
success: success 
fail: fail 
save: save 
snapshot: snapshot 
open: open 
href: href 
title: title 
share: share 
via: via 
screenshot: screenshot 
collected: collected 
organization: organization 
team: team 
formed: formed 
confused: confused 
rogue: rogue 
archivist: archivist 
collective: collective 
dedicated: dedicated 
saving: saving 
copy: copies 
rapidly: rapidly 
dying: dying 
deleted: deleted 
website: website websites 
sake: sake 
history: history 
digital: digital 
heritage: heritage 
group: group 
composed: composed 
volunteer: volunteer volunteers 
interested: interested 
party: parties 
expanded: expanded 
large: large 
amount: amount 
related: related 
project: projects 
online: online 
littered: littered 
hundred: hundreds hundred 
conflict: conflicts 
future: future 
community: community 
location: location 
business: business 
resolved: resolved 
one: one 
stepped: stepped 
ahead: ahead 
destroyed: destroyed 
original: original 
point: point 
contention: contention 
debate: debate debates 
would: would 
fall: fall 
wayside: wayside 
belief: believes 
duplicated: duplicated 
condemned: condemned 
data: data 
conversation: conversation 
continue: continue 
well: well 
richness: richness 
insight: insight 
gained: gained 
keeping: keeping 
material: materials 
ranged: ranged 
size: size 
single: single 
downloading: downloading 
small: small 
critical: critical 
site: sites site 
stepping: stepping 
forward: forward 
acquire: acquire 
terabyte: terabyte terabytes 
user: user 
created: created 
generation: generations 
main: main 
archiveteam: archiveteam 
contains: contains 
date: date 
information: information 
various: various 
manifesto: manifestos 
plan: plans 
walkthroughs: walkthroughs 
collection: collection collections 
output: output 
many: many 
ongoing: ongoing 
completed: completed 
thanks: thanks 
generous: generous 
providing: providing 
disk: disk 
space: space 
internet: internet 
multi: multi 
datasets: datasets 
made: made 
available: available 
use: use 
wayback: wayback 
machine: machine 
path: path 
back: back 
lost: lost 
work: work 
grown: grown 
sub: sub 
type: type 
seeking: seeking 
browse: browse 
content: content contents 
best: best 
first: first 
stop: stop 
otherwise: otherwise 
free: free 
dig: dig 
stack: stacks 
see: see 
may: may 
find: find 
panic: panic 
downloads: downloads 
full: full 
pulldowns: pulldowns 
currently: currently 
extant: extant 
meant: meant 
serve: serve 
emergency: emergency 
backup: backups 
needed: needed 
danger: danger 
closing: closing 
missed: missed 
dearly: dearly 
suddenly: suddenly 
due: due 
hard: hard 
drive: drive 
crash: crashes 
server: servers server 
failure: failures 
archivebot: archivebot 
crowdsourced: crowdsourced 
crawler: crawler 
irc: irc 
bot: bot 
designed: designed 
automate: automate 
archival: archival 
smaller: smaller 
e: e 
g: g 
thousand: thousand 
url: urls url 
give: give 
start: start 
grab: grabs 
record: records 
warc: warc 
uploads: uploads 
eventual: eventual 
injection: injection 
drop: drop 
efnet: efnet 
interact: interact 
issue: issue 
command: commands 
typing: typing 
channel: channel 
note: note 
need: need 
operator: operator 
permission: permissions 
order: order 
archiving: archiving 
job: jobs 
dashboard: dashboard 
show: shows 
downloaded: downloaded 
running: running 
process: process 
source: source 
code: code 
found: found 
timestamps: timestamps 
bt: bt 
false: false 
notice: notice 
javascript: javascript 
essential: essential 
interaction: interaction 
limited: limited 
please: please 
turn: turn 
experience: experience 
browser: browser 
ancient: ancient 
upgrade: upgrade 
different: different 
better: better 
