permissive: permissive 
software: software 
license: license licenses 
wikipedia: wikipedia 
free: free 
encyclopedia: encyclopedia 
jump: jump 
navigation: navigation 
search: search 
minimal: minimal 
requirement: requirements requirement 
redistributed: redistributed 
public: public 
domain: domain 
equivalent: equivalents equivalent 
copyleft: copyleft 
protective: protective 
noncommercial: noncommercial 
proprietary: proprietary 
trade: trade 
secret: secret 
description: description 
grant: grants 
right: rights right 
use: use 
including: including 
relicense: relicense 
allows: allows 
proprietization: proprietization 
compatibility: compatibility 
forbids: forbids 
may: may 
combined: combined 
traditional: traditional 
copyright: copyright 
need: need needs 
granted: granted 
information: information 
made: made 
pd: pd 
cc: cc 
bsd: bsd 
mit: mit 
apache: apache 
gpl: gpl 
agpl: agpl 
jrl: jrl 
afpl: afpl 
private: private 
internal: internal 
creative: creative 
work: work works 
sa: sa 
nc: nc 
unpublished: unpublished 
sometimes: sometimes 
also: also 
called: called 
like: like 
style: styles style 
instead: instead 
protection: protections 
carry: carries 
restriction: restrictions restriction 
used: used 
modified: modified 
usually: usually 
warranty: warranty warranties 
disclaimer: disclaimer 
example: examples example 
include: include 
gnu: gnu 
apple: apple 
source: source 
update: update 
popular: popular 
content: content contents 
definition: definitions definition 
comparison: comparison 
reception: reception 
adoption: adoption 
term: terms term 
copycenter: copycenter 
pushover: pushover 
see: see 
reference: references 
external: external 
link: link links 
edit: edit 
following: following 
full: full 
text: text 
simple: simple 
mw: mw 
parser: parser 
output: output 
templatequote: templatequote 
overflow: overflow 
hidden: hidden 
margin: margin 
em: em 
padding: padding 
px: px 
templatequotecite: templatequotecite 
line: lines line 
height: height 
align: align 
left: left 
top: top 
year: year years 
author: authors 
copying: copying 
distribution: distribution 
file: files file 
without: without 
modification: modification 
permitted: permitted 
medium: medium media 
royalty: royalty 
provided: provided 
notice: notices notice 
preserved: preserved 
offered: offered 
open: open 
initiative: initiative 
defines: defines 
non: non 
guarantee: guarantee guarantees 
freedom: freedom freedoms 
modify: modify 
redistribute: redistribute 
github: github 
choosealicense: choosealicense 
website: website 
describes: describes 
letting: letting 
people: people 
anything: anything 
want: want 
code: code 
long: long 
provide: provide 
attribution: attribution 
back: back 
hold: hold 
liable: liable 
california: california 
western: western 
school: school 
law: law 
newmediarights: newmediarights 
com: com 
defined: defined 
follows: follows 
extremely: extremely 
requiring: requiring 
little: little 
attributing: attributing 
original: original 
portion: portions 
licensed: licensed 
developer: developers developer 
documentation: documentation 
hatnote: hatnote 
font: font 
italic: italic 
div: div 
bottom: bottom 
normal: normal 
generally: generally 
require: require 
reciprocal: reciprocal 
publication: publication 
version: versions version 
contrast: contrast 
try: tries try 
remain: remain 
publicly: publicly 
available: available 
retained: retained 
result: result 
derivative: derivatives derivative 
future: future 
permissively: permissively 
released: released 
defining: defining 
much: much 
liberal: liberal 
however: however 
something: something 
easily: easily 
quantifiable: quantifiable 
often: often 
depends: depends 
goal: goals 
final: final 
user: users user 
latter: latter 
might: might 
valuable: valuable 
exploit: exploit 
written: written 
others: others 
possibly: possibly 
incorporate: incorporate 
make: makes make 
money: money 
therefore: therefore 
offering: offering 
know: know 
nobody: nobody 
ever: ever 
capitalize: capitalize 
mostly: mostly 
furthermore: furthermore 
case: case cases 
offer: offer 
everlasting: everlasting 
access: access 
ensuring: ensuring 
never: never 
become: become 
closed: closed 
could: could 
theoretically: theoretically 
one: one 
day: day 
another: another 
malware: malware 
even: even 
knowing: knowing 
extensive: extensive 
cannot: cannot 
freely: freely 
mixed: mixed 
reciprocity: reciprocity 
conflict: conflict 
computer: computer 
associate: associates 
int: int 
l: l 
v: v 
altai: altai 
refer: refer 
widely: widely 
shared: shared 
distributed: distributed 
permission: permission 
rather: rather 
deliberately: deliberately 
put: put 
actually: actually 
releasing: releasing 
stipulate: stipulate 
limited: limited 
must: must 
credited: credited 
truly: truly 
legally: legally 
required: required 
united: united 
state: state states 
registration: registration 
requires: requires 
disclosing: disclosing 
material: material materials 
previously: previously 
published: published 
still: still 
considered: considered 
ethical: ethical 
academia: academia 
advocate: advocates 
recommend: recommend 
attempting: attempting 
release: release 
ground: grounds 
problematic: problematic 
jurisdiction: jurisdictions 
attempt: attempt 
solve: solve 
problem: problem 
providing: providing 
fallback: fallback 
renunciation: renunciation 
possible: possible 
similar: similar 
main: main 
article: articles article 
common: common commons 
fo: foss 
according: according 
david: david 
wheeler: wheeler 
vector: vector 
arrow: arrows 
denote: denote 
directional: directional 
better: better 
side: side 
general: general 
good: good 
situation: situation situations 
due: due 
restrictiveness: restrictiveness 
compatible: compatible 
incompatible: incompatible 
older: older 
clause: clause clauses 
php: php 
openssl: openssl 
advertising: advertising 
credit: credit 
holder: holder 
modern: modern 
zlib: zlib 
allow: allow 
derived: derived 
add: add 
say: say says 
redistributor: redistributor 
cddl: cddl 
mspl: mspl 
citation: citation 
needed: needed 
since: since 
mid: mid 
several: several 
noted: noted 
increase: increase 
popularity: popularity 
followed: followed 
gplv: gplv 
max: max 
width: width 
rquote: rquote 
auto: auto 
important: important 
float: float 
none: none 
berkeley: berkeley 
take: take 
copy: copy copies 
center: center 
many: many 
marshall: marshall 
kirk: kirk 
mckusick: mckusick 
originally: originally 
explain: explain 
presented: presented 
scientist: scientist 
contributor: contributor 
conference: conference 
word: word words 
play: play 
foundation: foundation 
guide: guide 
relicensing: relicensing 
richard: richard 
stallman: stallman 
comparing: comparing 
seen: seen 
granting: granting 
deny: deny 
recommends: recommends 
small: small 
program: program programs 
benefit: benefits 
justify: justify 
inconvenience: inconvenience 
making: making 
sure: sure 
always: always 
accompanies: accompanies 
portalbox: portalbox 
border: border 
solid: solid 
aaa: aaa 
tleft: tleft 
tright: tright 
ul: ul 
display: display 
table: table 
box: box 
sizing: sizing 
background: background 
f: f 
size: size 
weight: weight 
bold: bold 
li: li 
row: row 
span: span 
first: first 
child: child 
cell: cell 
vertical: vertical 
middle: middle 
last: last 
portal: portal 
list: list 
reflist: reflist 
type: types type 
decimal: decimal 
inherit: inherit 
column: columns column 
ol: ol 
page: page pages 
break: break 
inside: inside 
avoid: avoid 
upper: upper 
alpha: alpha 
roman: roman 
lower: lower 
greek: greek 
b: b 
c: cs c 
cite: cite 
wrap: wrap 
q: q 
quote: quotes 
target: target 
color: color 
rgba: rgba 
id: id 
lock: lock 
linear: linear 
gradient: gradient 
transparent: transparent 
url: url 
upload: upload 
wikimedia: wikimedia 
org: org 
green: green 
svg: svg 
repeat: repeat 
gray: gray 
alt: alt 
subscription: subscription 
aa: aa 
red: red 
w: ws 
icon: icon 
wikisource: wikisource 
logo: logo 
error: error 
visible: visible 
maint: maint 
format: format 
kern: kern 
selflink: selflink 
new: new 
licensing: licensing 
black: black 
duck: duck 
november: november 
archived: archived 
july: july 
retrieved: retrieved 
revised: revised 
lesser: lesser 
lgpl: lgpl 
artistic: artistic 
perl: perl 
microsoft: microsoft 
eclipse: eclipse 
epl: epl 
balter: balter 
ben: ben 
usage: usage 
unlicense: unlicense 
lgplv: lgplv 
agplv: agplv 
various: various 
comment: comments comment 
maintainer: maintainers 
opensource: opensource 
simply: simply 
permit: permits permit 
choosing: choosing 
scary: scary 
best: best 
april: april 
category: categories category 
nonfree: nonfree 
amadeo: amadeo 
ron: ron 
google: google 
iron: iron 
grip: grip 
android: android 
controlling: controlling 
mean: means 
necessary: necessary 
ar: ars 
technica: technica 
mind: mind 
freebsd: freebsd 
project: project 
company: companies company 
commercial: commercial 
place: places place 
behavior: behavior 
argue: argue 
legal: legal 
time: time 
bomb: bombs bomb 
montague: montague 
bruce: bruce 
advantage: advantages 
disadvantage: disadvantages 
conclusion: conclusion 
designed: designed 
prevent: prevent 
commercialization: commercialization 
integrated: integrated 
solution: solutions 
change: changes change 
point: point 
development: development 
process: process 
addition: addition 
come: come 
complexity: complexity 
spend: spend 
creating: creating 
promoting: promoting 
worrying: worrying 
violates: violates 
licence: licence 
european: european 
union: union 
joinup: joinup 
ec: ec 
europa: europa 
eu: eu 
distributing: distributing 
divided: divided 
two: two 
family: families 
x: x 
zope: zope 
interoperable: interoperable 
tolerating: tolerating 
merge: merge 
combine: combine 
improve: improve 
covered: covered 
distribute: distribute 
hanwell: hanwell 
marcus: marcus 
simplifies: simplifies 
thing: things 
reason: reason 
business: business 
world: world 
favor: favor 
simplicity: simplicity 
reuse: reuse 
pertains: pertains 
infer: infer 
condition: conditions 
upon: upon 
component: component 
define: define 
constitutes: constitutes 
chart: chart 
seems: seems 
frequently: frequently 
asked: asked 
question: questions 
installation: installation 
exist: exist 
tried: tried 
would: would 
violate: violate 
section: section 
later: later 
option: options 
landley: landley 
rob: rob 
celf: celf 
toybox: toybox 
talk: talk 
net: net 
broke: broke 
fork: forks 
share: share 
interpreting: interpreting 
enforcing: enforcing 
changing: changing 
applied: applied 
combining: combining 
linux: linux 
zfs: zfs 
fsf: fsf 
u: us 
office: office 
form: form 
co: co 
ashton: ashton 
tate: tate 
fox: fox 
openbsd: openbsd 
policy: policy 
doubtful: doubtful 
whether: whether 
voluntarily: voluntarily 
placing: placing 
substantial: substantial 
body: body 
preferable: preferable 
isc: isc 
hipp: hipp 
sqlite: sqlite 
succeeded: succeeded 
database: database 
changelog: changelog 
realize: realize 
lived: lived 
whole: whole 
life: life 
british: british 
recognized: recognized 
lot: lot 
difficult: difficult 
impossible: impossible 
someone: someone 
complication: complication complications 
libre: libre 
floss: floss 
slide: slide 
october: october 
haff: haff 
gordon: gordon 
mysterious: mysterious 
history: history 
argument: argument 
consortium: consortium 
crystallized: crystallized 
date: date 
created: created 
adjustment: adjustments 
next: next 
couple: couple 
vaughan: vaughan 
nichols: nichols 
steven: steven 
j: j 
fall: fall 
rise: rise 
zdnet: zdnet 
declining: declining 
gaining: gaining 
fan: fans 
ronacher: ronacher 
armin: armin 
post: post 
lucumr: lucumr 
pocoo: pocoo 
aslett: aslett 
matthew: matthew 
trend: trends trend 
towards: towards 
group: group 
posted: posted 
jason: jason 
hibbets: hibbets 
favoring: favoring 
certain: certain 
community: community 
definitely: definitely 
seeing: seeing 
away: away 
pas: pass 
historical: historical 
fortune: fortune 
raymond: raymond 
eric: eric 
jargon: jargon 
lax: lax 
expat: expat 
python: python 
etc: etc 
added: added 
putting: putting 
entire: entire 
perhaps: perhaps 
product: product 
thus: thus 
call: calls call 
choose: choose 
wikibooks: wikibooks 
book: book 
topic: topics topic 
navbox: navbox 
clear: clear 
inner: inner 
subgroup: subgroup 
title: title 
abovebelow: abovebelow 
white: white 
space: space 
nowrap: nowrap 
fdfdfd: fdfdfd 
tr: tr 
image: image 
ccf: ccf 
ddf: ddf 
e: e 
ff: ff 
odd: odd 
hlist: hlist 
td: td 
dl: dl 
navbar: navbar 
block: block 
inline: inline 
collapse: collapse 
boxtext: boxtext 
spacing: spacing 
bracket: brackets 
abbr: abbr 
decoration: decoration 
mini: mini 
variant: variant 
cap: caps 
cursor: cursor 
ct: ct 
alternative: alternative 
hosting: hosting 
facility: facilities 
directory: directories 
gratis: gratis 
versus: versus 
support: support 
outline: outline 
timeline: timeline 
package: packages 
audio: audio 
bioinformatics: bioinformatics 
codecs: codecs 
configuration: configuration 
management: management 
driver: drivers 
graphic: graphics 
wireless: wireless 
geophysics: geophysics 
health: health 
mathematics: mathematics 
suite: suites 
operating: operating 
system: systems 
programming: programming 
language: languages 
routing: routing 
television: television 
video: video 
game: games 
web: web 
application: applications 
commerce: commerce 
apps: apps 
io: ios 
trademarked: trademarked 
formerly: formerly 
movement: movement 
event: events 
organisation: organisations 
india: india 
afl: afl 
apsl: apsl 
beerware: beerware 
mpl: mpl 
sleepycat: sleepycat 
wtfpl: wtfpl 
standard: standards 
agreement: agreement 
debian: debian 
guideline: guidelines 
cultural: cultural 
viral: viral 
challenge: challenges 
digital: digital 
hardware: hardware 
proliferation: proliferation 
mozilla: mozilla 
rebranding: rebranding 
device: device 
firmware: firmware 
sco: sco 
controversy: controversies 
patent: patents 
security: security 
trusted: trusted 
computing: computing 
related: related 
forking: forking 
manifesto: manifesto 
specification: specification 
promise: promise 
core: core 
model: model 
cathedral: cathedral 
bazaar: bazaar 
revolution: revolution 
o: os 
newpp: newpp 
limit: limit 
report: report 
parsed: parsed 
cached: cached 
cache: cache 
expiry: expiry 
reduced: reduced 
false: false 
vary: vary 
revision: revision 
sha: sha 
cpu: cpu 
second: seconds 
real: real 
preprocessor: preprocessor 
visited: visited 
node: node 
count: count 
expand: expand 
byte: bytes 
template: template 
highest: highest 
expansion: expansion 
depth: depth 
expensive: expensive 
function: function 
unstrip: unstrip 
recursion: recursion 
lua: lua 
memory: memory 
number: number 
wikibase: wikibase 
entity: entities 
loaded: loaded 
transclusion: transclusion 
m: ms 
total: total 
short: short 
sister: sister 
fact: fact 
saved: saved 
key: key 
enwiki: enwiki 
pcache: pcache 
idhash: idhash 
canonical: canonical 
timestamp: timestamp 
serialized: serialized 
json: json 
oldid: oldid 
match: matches 
wikidata: wikidata 
american: american 
english: english 
september: september 
containing: containing 
potentially: potentially 
dated: dated 
statement: statements 
unsourced: unsourced 
june: june 
incorrectly: incorrectly 
using: using 
blockquote: blockquote 
menu: menu 
