rebbie: rebbie 
jackson: jackson jacksons 
biography: biography 
skip: skip 
main: main 
content: content 
people: people 
nostalgia: nostalgia 
celebrity: celebrity 
history: history 
culture: culture 
crime: crime 
scandal: scandal 
video: video 
contact: contact 
u: us u 
advertise: advertise 
privacy: privacy 
notice: notice 
term: terms 
use: use 
copyright: copyright 
policy: policy 
ad: ad 
choice: choices 
accessibility: accessibility 
support: support 
setting: settings 
february: february 
subscribe: subscribe 
newsletter: newsletter 
quick: quick 
fact: facts fact 
name: name 
occupation: occupation 
singer: singers singer 
birth: birth 
date: date 
may: may 
age: age 
place: place 
gary: gary 
indiana: indiana 
originally: originally 
maureen: maureen 
reillette: reillette 
zodiac: zodiac 
sign: sign 
gemini: gemini 
song: song songs 
cite: cite 
page: page 
publish: publish 
apr: apr 
comment: comment 
eldest: eldest 
child: children child 
famous: famous 
musical: musical 
family: family 
long: long 
career: career 
r: r 
b: b 
solo: solo 
artist: artists artist 
collaborated: collaborated 
michael: michael 
produce: produce 
number: number 
one: one 
hit: hits hit 
centipede: centipede 
went: went 
release: release 
successful: successful 
album: albums album 
including: including 
reaction: reaction 
ru: ru 
tuff: tuff 
enuff: enuff 
faithfully: faithfully 
featured: featured 
contribution: contributions 
married: married 
childhood: childhood 
sweetheart: sweetheart 
nathaniel: nathaniel 
brown: brown 
husband: husband 
kid: kids 
couple: couple 
three: three 
two: two 
daughter: daughters daughter 
stacee: stacee 
yashi: yashi 
son: son 
austin: austin 
performer: performers 
formed: formed 
group: group 
called: called 
x: x 
girl: girls 
known: known 
geneva: geneva 
also: also 
auggie: auggie 
gave: gave 
first: first 
grandchild: grandchild 
london: london 
blue: blue 
died: died 
january: january 
battle: battle 
cancer: cancer 
collaboration: collaboration 
brother: brother 
co: co 
write: write 
debut: debut 
columbia: columbia 
label: label 
reached: reached 
billboard: billboard 
hot: hot 
hip: hip 
hop: hop 
single: single singles 
track: tracks 
gold: gold 
based: based 
mostly: mostly 
success: success 
released: released 
second: second 
read: read 
next: next 
bella: bella 
hadid: hadid 
sadie: sadie 
alexander: alexander 
adrienne: adrienne 
kennedy: kennedy 
produced: produced 
member: member members 
surface: surface 
tito: tito 
popular: popular 
duet: duets 
cheap: cheap 
trick: trick 
lead: lead 
robin: robin 
zander: zander 
star: star 
isaac: isaac 
hayes: hayes 
plaything: plaything 
third: third 
top: top 
due: due 
popularity: popularity 
england: england 
compilation: compilation 
entitled: entitled 
collection: collection 
expansion: expansion 
last: last 
mjj: mjj 
early: early 
life: life lives 
born: born 
joseph: joseph 
katherine: katherine 
mother: mother 
became: became 
jehovah: jehovah 
witness: witness 
followed: followed 
suit: suit 
become: become 
devoted: devoted 
religion: religion 
began: began 
performing: performing 
la: las 
vega: vegas 
show: show shows 
television: television 
variety: variety 
started: started 
outside: outside 
background: background 
act: acts 
like: like 
lou: lou 
rawls: rawls 
chaka: chaka 
khan: khan 
check: check 
strive: strive 
accuracy: accuracy 
fairness: fairness 
see: see 
something: something 
look: look 
right: right 
citation: citation 
information: information 
article: article 
title: title 
author: author 
com: com 
editor: editors 
website: website 
url: url 
access: access 
publisher: publisher 
e: e 
network: networks 
updated: updated 
august: august 
original: original 
published: published 
april: april 
receive: receive 
story: stories 
shaped: shaped 
world: world 
person: person 
janet: janet 
youngest: youngest 
sibling: sibling 
best: best 
selling: selling 
contemporary: contemporary 
roster: roster 
includes: includes 
control: control 
rhythm: rhythm 
nation: nation 
velvet: velvet 
rope: rope 
unbreakable: unbreakable 
randy: randy 
musician: musician 
came: came 
fame: fame 
pop: pop 
multi: multi 
talented: talented 
entertainer: entertainer 
enjoyed: enjoyed 
chart: chart 
topping: topping 
thriller: thriller 
bad: bad 
wall: wall 
jermaine: jermaine 
music: music 
international: international 
superstar: superstar 
rest: rest 
paris: paris 
legend: legend 
father: father 
tj: tj 
temporary: temporary 
guardianship: guardianship 
cousin: cousins 
prince: prince 
blanket: blanket 
late: late 
mahalia: mahalia 
th: th 
century: century 
recording: recording 
queen: queen 
gospel: gospel 
revered: revered 
greatest: greatest 
figure: figures 
loading: loading 
logo: logo 
registered: registered 
trademark: trademarks 
llc: llc 
close: close 
