pytorch: pytorch 
wikipedia: wikipedia 
free: free 
encyclopedia: encyclopedia 
jump: jump 
navigation: navigation 
search: search 
open: open 
source: source sources 
machine: machine 
learning: learning 
library: library libraries 
python: python 
based: based 
torch: torch 
mw: mw 
parser: parser 
output: output 
infobox: infobox 
subbox: subbox 
padding: padding 
border: border 
none: none 
margin: margin 
px: px 
width: width 
auto: auto 
min: min 
font: font 
size: size 
clear: clear 
float: float 
background: background 
color: color 
transparent: transparent 
col: cols 
child: child 
navbar: navbar 
body: body 
skin: skin 
minerva: minerva 
header: header 
subheader: subheader 
title: title 
image: image 
full: full 
data: data 
text: text 
align: align 
center: center 
original: original 
author: author 
adam: adam 
paszke: paszke 
sam: sam 
gross: gross 
soumith: soumith 
chintala: chintala 
gregory: gregory 
chanan: chanan 
developer: developer 
facebook: facebook 
ai: ai 
research: research 
lab: lab labs 
fair: fair 
initial: initial 
release: release 
september: september 
year: years 
ago: ago 
stable: stable 
december: december 
day: days 
repository: repository 
github: github 
com: com 
written: written 
c: cs c 
cuda: cuda 
operating: operating 
system: system systems 
linux: linux 
macos: macos 
window: windows 
platform: platform 
ia: ia 
x: x 
available: available 
english: english 
type: types type 
deep: deep 
license: license 
bsd: bsd 
website: website 
org: org 
framework: framework frameworks 
used: used 
application: applications application 
computer: computers computer 
vision: vision 
natural: natural 
language: language languages 
processing: processing 
primarily: primarily 
developed: developed 
software: software 
released: released 
modified: modified 
although: although 
interface: interface 
polished: polished 
primary: primary 
focus: focus 
development: development 
also: also 
number: number numbers 
piece: pieces 
built: built 
top: top 
including: including 
tesla: tesla 
autopilot: autopilot 
uber: uber 
pyro: pyro 
hugging: hugging 
face: face 
transformer: transformer transformers 
lightning: lightning 
catalyst: catalyst 
provides: provides 
two: two 
high: high 
level: level 
feature: features feature 
tensor: tensors tensor 
computing: computing 
like: like 
numpy: numpy 
strong: strong 
acceleration: acceleration 
via: via 
graphic: graphics 
unit: units 
gpu: gpu 
neural: neural 
network: networks network 
automatic: automatic 
differentiation: differentiation 
content: content contents 
history: history 
module: modules module 
autograd: autograd 
optim: optim 
nn: nn 
example: example 
see: see 
reference: references 
external: external 
link: links 
edit: edit 
operates: operates 
convolutional: convolutional 
architecture: architecture 
fast: fast 
embedding: embedding 
caffe: caffe 
model: models 
defined: defined 
mutually: mutually 
incompatible: incompatible 
exchange: exchange 
onnx: onnx 
project: project 
created: created 
microsoft: microsoft 
converting: converting 
merged: merged 
end: end 
march: march 
defines: defines 
class: class 
called: called 
store: store 
operate: operate 
homogeneous: homogeneous 
multidimensional: multidimensional 
rectangular: rectangular 
array: arrays 
similar: similar 
operated: operated 
capable: capable 
nvidia: nvidia 
support: supports 
various: various 
sub: sub 
note: note 
term: term 
carry: carry 
meaning: meaning 
mathematics: mathematics 
physic: physics 
word: word 
area: areas 
tangentially: tangentially 
related: related 
one: one 
certain: certain 
kind: kind 
object: object 
linear: linear 
algebra: algebra 
usually: usually 
refers: refers 
mathematician: mathematicians 
call: calls call 
field: field 
us: uses 
method: method methods 
recorder: recorder 
record: records 
operation: operations 
performed: performed 
replay: replays 
backward: backward 
compute: compute 
gradient: gradients gradient 
especially: especially 
powerful: powerful 
building: building 
save: save 
time: time 
epoch: epoch 
calculating: calculating 
parameter: parameters 
forward: forward 
pas: pass 
implement: implements 
optimization: optimization 
algorithm: algorithms 
commonly: commonly 
already: already 
supported: supported 
need: need 
build: build 
scratch: scratch 
make: makes 
easy: easy 
define: define 
computational: computational 
graph: graphs 
take: take 
raw: raw 
bit: bit 
low: low 
defining: defining 
complex: complex 
help: help 
following: following 
program: program 
show: shows 
functionality: functionality 
simple: simple 
import: import 
dtype: dtype 
device: device 
cpu: cpu 
executes: executes 
calculation: calculations 
creation: creation 
filling: filling 
random: random 
randn: randn 
print: print 
b: b 
multiplication: multiplication 
sum: sum 
element: element elements 
third: third 
column: columns column 
second: second seconds 
row: row 
minimum: minimum 
value: value 
portalbox: portalbox 
right: right 
solid: solid 
aaa: aaa 
tleft: tleft 
em: em 
tright: tright 
ul: ul 
display: display 
table: table 
box: box 
sizing: sizing 
max: max 
f: f 
line: line 
height: height 
style: styles style 
italic: italic 
weight: weight 
bold: bold 
li: li 
span: span 
first: first 
cell: cell 
vertical: vertical 
middle: middle 
last: last 
portal: portals portal 
comparison: comparison 
differentiable: differentiable 
programming: programming 
deepspeed: deepspeed 
reflist: reflist 
bottom: bottom 
list: list 
decimal: decimal 
inherit: inherit 
ol: ol 
page: page 
break: break 
inside: inside 
avoid: avoid 
upper: upper 
alpha: alpha 
roman: roman 
lower: lower 
greek: greek 
cite: cite 
citation: citation 
wrap: wrap 
q: q 
quote: quotes 
target: target 
rgba: rgba 
id: id 
lock: lock 
url: url 
upload: upload 
wikimedia: wikimedia 
common: commons 
green: green 
svg: svg 
repeat: repeat 
limited: limited 
registration: registration 
gray: gray 
alt: alt 
subscription: subscription 
aa: aa 
red: red 
w: ws 
icon: icon 
wikisource: wikisource 
logo: logo 
code: code 
hidden: hidden 
error: error 
visible: visible 
maint: maint 
left: left 
format: format 
kern: kern 
selflink: selflink 
small: small 
bug: bug 
fix: fix 
retrieved: retrieved 
january: january 
yegulalp: yegulalp 
serdar: serdar 
brings: brings 
powered: powered 
infoworld: infoworld 
lorica: lorica 
ben: ben 
august: august 
researcher: researchers 
beginning: beginning 
embrace: embrace 
reilly: reilly 
medium: media 
ketkar: ketkar 
nikhil: nikhil 
introduction: introduction 
apress: apress 
berkeley: berkeley 
ca: ca 
pp: pp 
doi: doi 
isbn: isbn 
nlp: nlp 
documentation: documentation 
dl: dl 
info: info 
patel: patel 
mo: mo 
trend: trends 
fuse: fuse 
recommender: recommender 
mannes: mannes 
john: john 
collaborate: collaborate 
simplify: simplify 
conversion: conversions 
techcrunch: techcrunch 
accustomed: accustomed 
working: working 
optimized: optimized 
achieving: achieving 
state: state 
art: art 
result: results 
regardless: regardless 
resource: resource 
constraint: constraints 
unfortunately: unfortunately 
real: real 
world: world 
u: us 
capability: capabilities 
smartphones: smartphones 
arakelyan: arakelyan 
sophia: sophia 
tech: tech 
giant: giants 
using: using 
dominate: dominate 
community: community 
venturebeat: venturebeat 
frontend: frontend 
master: master 
karpathy: karpathy 
andrej: andrej 
probabilistic: probabilistic 
engineering: engineering 
blog: blog 
implementation: implementations implementation 
popular: popular 
hub: hub 
lightweight: lightweight 
wrapper: wrapper 
ml: ml 
scale: scale 
write: write 
le: less 
boilerplate: boilerplate 
team: team 
ecosystem: ecosystem 
tool: tools 
accelerated: accelerated 
rl: rl 
archived: archived 
merges: merges 
yet: yet 
analyticsvidhya: analyticsvidhya 
official: official 
navbox: navbox 
inner: inner 
subgroup: subgroup 
group: group 
abovebelow: abovebelow 
white: white 
space: space 
nowrap: nowrap 
fdfdfd: fdfdfd 
tr: tr 
ccf: ccf 
ddf: ddf 
e: e 
ff: ff 
even: even 
odd: odd 
hlist: hlist 
td: td 
block: block 
inline: inline 
normal: normal 
collapse: collapse 
boxtext: boxtext 
spacing: spacing 
bracket: brackets 
abbr: abbr 
decoration: decoration 
mini: mini 
variant: variant 
cap: caps 
cursor: cursor 
ct: ct 
v: v 
apache: apache 
mxnet: mxnet 
singa: singa 
deeplearning: deeplearning 
j: j 
dlib: dlib 
kera: keras 
cognitive: cognitive 
toolkit: toolkit 
net: net 
opennn: opennn 
tensorflow: tensorflow 
theano: theano 
openvino: openvino 
proprietary: proprietary 
apple: apple 
core: core 
ibm: ibm 
watson: watson 
maple: maple 
designer: designer 
wolfram: wolfram 
mathematica: mathematica 
matlab: matlab 
toolbox: toolbox 
category: categories category 
general: general 
turing: turing 
neuromorphic: neuromorphic 
cable: cable 
theory: theory 
pattern: pattern 
recognition: recognition 
calculus: calculus 
concept: concepts 
descent: descent 
sgd: sgd 
clustering: clustering 
regression: regression 
overfitting: overfitting 
adversary: adversary 
attention: attention 
convolution: convolution 
loss: loss 
function: function functions 
backpropagation: backpropagation 
normalization: normalization 
activation: activation 
softmax: softmax 
sigmoid: sigmoid 
rectifier: rectifier 
regularization: regularization 
datasets: datasets 
augmentation: augmentation 
julia: julia 
artificial: artificial 
scientific: scientific 
intelligence: intelligence 
hardware: hardware 
ipu: ipu 
tpu: tpu 
vpu: vpu 
memristor: memristor 
spinnaker: spinnaker 
audio: audio 
visual: visual 
alexnet: alexnet 
wavenet: wavenet 
human: human 
synthesis: synthesis 
hwr: hwr 
ocr: ocr 
speech: speech 
facial: facial 
alphafold: alphafold 
dall: dall 
verbal: verbal 
vec: vec 
bert: bert 
nmt: nmt 
debater: debater 
gpt: gpt 
decisional: decisional 
alphago: alphago 
alphazero: alphazero 
sarsa: sarsa 
openai: openai 
five: five 
self: self 
driving: driving 
car: car 
muzero: muzero 
action: action 
selection: selection 
robot: robot 
control: control 
people: people 
alex: alex 
graf: graves 
ian: ian 
goodfellow: goodfellow 
yoshua: yoshua 
bengio: bengio 
geoffrey: geoffrey 
hinton: hinton 
yann: yann 
lecun: lecun 
andrew: andrew 
ng: ng 
demis: demis 
hassabis: hassabis 
david: david 
silver: silver 
fei: fei 
organization: organizations 
deepmind: deepmind 
mit: mit 
csail: csail 
mila: mila 
google: google 
brain: brain 
technology: technology 
newpp: newpp 
limit: limit 
report: report 
parsed: parsed 
cached: cached 
cache: cache 
expiry: expiry 
reduced: reduced 
true: true 
complication: complications 
vary: vary 
revision: revision 
sha: sha 
usage: usage 
preprocessor: preprocessor 
visited: visited 
node: node 
count: count 
post: post 
expand: expand 
include: include 
byte: bytes 
template: template 
argument: argument 
highest: highest 
expansion: expansion 
depth: depth 
expensive: expensive 
unstrip: unstrip 
recursion: recursion 
lua: lua 
memory: memory 
wikibase: wikibase 
entity: entities 
loaded: loaded 
transclusion: transclusion 
m: ms 
total: total 
wikidata: wikidata 
short: short 
description: description 
web: web 
saved: saved 
key: key 
enwiki: enwiki 
pcache: pcache 
idhash: idhash 
canonical: canonical 
timestamp: timestamp 
serialized: serialized 
json: json 
oldid: oldid 
applied: applied 
mining: mining 
science: science 
programmed: programmed 
article: articles 
match: matches 
menu: menu 
