python: python 
proqramla: proqramla 
rma: rma 
dili: dili 
vikipediya: vikipediya 
azad: azad 
ensiklopediya: ensiklopediya 
jump: jump 
navigation: navigation 
search: search 
bu: bu 
ad: ad 
n: n 
dig: dig 
r: r 
istifad: istifad 
formalar: formalar 
bax: bax 
yarad: yarad 
lma: lma 
tarixi: tarixi 
fevral: fevral 
llifl: llifl 
qvido: qvido 
van: van 
rossum: rossum 
rtibat: rtibat 
lar: lar 
fayl: fayl 
sonlu: sonlu 
u: u 
py: py 
pyc: pyc 
pyd: pyd 
pyo: pyo 
pyw: pyw 
pyz: pyz 
v: v 
ya: ya 
pyi: pyi 
sonuncu: sonuncu 
versiyas: versiyas 
yanvar: yanvar 
sirl: sirl 
nib: nib 
c: cs c 
perl: perl 
java: java 
lisp: lisp 
haskell: haskell 
apl: apl 
icon: icon 
liyyat: liyyat 
sistemi: sistemi 
kross: kross 
platforma: platforma 
org: org 
vikianbarda: vikianbarda 
laq: laq 
li: li 
mediafayllar: mediafayllar 
interpretasiya: interpretasiya 
olunan: olunan 
k: ks k 
viyy: viyy 
mumi: mumi 
q: qs q 
dli: dli 
dilidir: dilidir 
ci: ci 
ild: ild 
guido: guido 
find: find 
lm: lm 
dilinin: dilinin 
dizayn: dizayn 
f: f 
l: l ls 
si: si 
bo: bo 
luqlardan: luqlardan 
ed: ed 
kod: kod 
oxunaql: oxunaql 
vur: vur 
ulay: ulay 
dilin: dilin 
di: di 
onun: onun 
dil: dil 
qurulu: qurulu 
obyekt: obyekt 
ml: ml 
il: il 
proqram: proqram 
lara: lara 
x: x 
rda: rda 
iri: iri 
h: h 
cimli: cimli 
layih: layih 
rd: rd 
ayd: ayd 
ntiqli: ntiqli 
yazma: yazma 
etm: etm 
kdir: kdir 
dinamik: dinamik 
yaz: yaz 
la: la 
bil: bil 
avtomatik: avtomatik 
yadda: yadda 
idar: idar 
susiyy: susiyy 
tin: tin 
malikdir: malikdir 
xt: xt 
lif: lif 
paradiqmalar: paradiqmalar 
st: st 
kl: kl 
yir: yir 
buna: buna 
daxildir: daxildir 
strukturlu: strukturlu 
qism: qism 
prosedurlu: prosedurlu 
funksional: funksional 
geni: geni 
standart: standart 
kitabxanas: kitabxanas 
oldu: oldu 
una: una 
g: g 
pythona: pythona 
bataryalar: bataryalar 
deyilir: deyilir 
ill: ill 
rin: rin 
sonlar: sonlar 
nda: nda 
abc: abc 
davam: davam 
olaraq: olaraq 
ld: ld 
qdim: qdim 
edildi: edildi 
z: z 
birlikd: birlikd 
siyah: siyah 
anlama: anlama 
zibil: zibil 
toplay: toplay 
sisteml: sisteml 
birg: birg 
referans: referans 
say: say 
tl: tl 
rini: rini 
tirdi: tirdi 
b: b 
reviziyas: reviziyas 
undan: undan 
vv: vv 
uy: uy 
unlu: unlu 
tam: tam 
deyil: deyil 
bir: bir 
ox: ox 
kodu: kodu 
yi: yi 
ikliy: ikliy 
ehtiyac: ehtiyac 
olmadan: olmadan 
bilmir: bilmir 
smi: smi 
dayand: dayand 
ilk: ilk 
lmas: lmas 
planla: planla 
son: son 
burax: burax 
bel: bel 
likl: likl 
da: da 
bunun: bunun 
daha: daha 
hl: hl 
sizlik: sizlik 
yama: yama 
yada: yada 
ba: ba 
qa: qa 
kmill: kmill 
dirm: dirm 
lmayacaq: lmayacaq 
ey: ey 
yaln: yaln 
sonras: sonras 
nir: nir 
ri: ri 
interpretatorlar: interpretatorlar 
vcuddur: vcuddur 
qlobal: qlobal 
miyy: miyy 
ti: ti 
qaynaq: qaynaq 
kodlu: kodlu 
istinad: istinad 
olan: olan 
cpythonu: cpythonu 
inki: inki 
af: af 
etdirir: etdirir 
cpython: cpython 
un: un 
qaynaqlari: qaynaqlari 
lir: lir 
dm: dm 
qurum: qurum 
software: software 
foundation: foundation 
edir: edir 
nl: nl 
ndirir: ndirir 
nd: nd 
ricat: ricat 
stifad: stifad 
sintaksisi: sintaksisi 
semantikas: semantikas 
salam: salam 
nya: nya 
rhl: rhl 
bloklar: bloklar 
funksiyalar: funksiyalar 
tipl: tipl 
stinadlar: stinadlar 
redakt: redakt 
nb: nb 
ni: ni 
et: et 
oscon: oscon 
sa: sas 
qal: qal 
istisna: istisna 
bacar: bacar 
amoeba: amoeba 
sisteminin: sisteminin 
ara: ara 
riyaziyyat: riyaziyyat 
kompyuter: kompyuter 
elml: elml 
zr: zr 
milli: milli 
rmalar: rmalar 
nstitutunda: nstitutunda 
olark: olark 
setl: setl 
ilham: ilham 
al: al 
haz: haz 
rlanmas: rlanmas 
cu: cu 
ilin: ilin 
dekabr: dekabr 
ay: ay 
lad: lad 
nin: nin 
etdiricisi: etdiricisi 
kc: kc 
zif: zif 
nun: nun 
yat: yat 
xeyirxah: xeyirxah 
diktatur: diktatur 
iyul: iyul 
daimi: daimi 
istirah: istirah 
tini: tini 
elan: elan 
etdirdi: etdirdi 
ona: ona 
uzun: uzun 
dd: dd 
tli: tli 
hb: hb 
rar: rar 
bul: bul 
hd: hd 
liyi: liyi 
unu: unu 
etdirm: etdirm 
edilmi: edilmi 
dir: dir 
ndi: ndi 
liderliyini: liderliyini 
rlik: rlik 
ur: ur 
zv: zv 
onlarla: onlarla 
kd: kd 
tr: tr 
aktiv: aktiv 
etdiricil: etdiricil 
brett: brett 
cannon: cannon 
nick: nick 
coghlan: coghlan 
barry: barry 
warsaw: warsaw 
carol: carol 
willing: willing 
dar: dar 
uras: uras 
na: na 
kimi: kimi 
se: se 
ildil: ildil 
yeni: yeni 
rl: rl 
oktyabr: oktyabr 
buraxild: buraxild 
bunlara: bunlara 
vr: vr 
karlayan: karlayan 
unikod: unikod 
revisiyas: revisiyas 
idi: idi 
ki: ki 
olmad: olmad 
oxu: oxu 
versiya: versiya 
serialar: serialar 
integrasiya: integrasiya 
ehtiva: ehtiva 
han: hans 
kodunun: kodunun 
olmuya: olmuya 
koduna: koduna 
rc: rc 
sini: sini 
avtomatla: avtomatla 
sonu: sonu 
ilkin: ilkin 
yin: yin 
sonra: sonra 
tarix: tarix 
ert: ert 
nki: nki 
miqdarda: miqdarda 
kodlar: kodlar 
evirm: evirm 
asan: asan 
olmayacaqd: olmayacaqd 
struktur: struktur 
funksiyonal: funksiyonal 
misal: misal 
ola: ola 
script: script 
veb: veb 
desktop: desktop 
hitl: hitl 
rind: rind 
olunur: olunur 
irk: irk 
google: google 
yahoo: yahoo 
dilind: dilind 
edirl: edirl 
rk: rk 
zl: zl 
cern: cern 
elmi: elmi 
hesablamalar: hesablamalar 
oxlu: oxlu 
kitabxanalara: kitabxanalara 
numpy: numpy 
scipy: scipy 
matplotlibi: matplotlibi 
rm: rm 
olar: olar 
pythonun: pythonun 
yr: yr 
nm: nm 
sad: sad 
pythond: pythond 
klassik: klassik 
dunya: dunya 
print: print 
funksiya: funksiya 
qeyd: qeyd 
tarixind: tarixind 
etibar: etibar 
versiyalar: versiyalar 
olur: olur 
dill: dill 
rqli: rqli 
initializ: initializ 
yoxdur: yoxdur 
qiym: qiym 
verm: verm 
ar: ar 
yazmaq: yazmaq 
laz: laz 
md: md 
var: var 
adl: adl 
tinin: tinin 
verilm: verilm 
pythonda: pythonda 
vasit: vasit 
rhdir: rhdir 
proqrama: proqrama 
siri: siri 
bird: bird 
misral: misral 
ancaq: ancaq 
alternativ: alternativ 
rnaq: rnaq 
yaxud: yaxud 
apastrofdan: apastrofdan 
nz: nz 
intendasiya: intendasiya 
tablar: tablar 
luqlar: luqlar 
qurulur: qurulur 
bloku: bloku 
def: def 
sintaksis: sintaksis 
arqumentl: arqumentl 
argument: argument 
parametirl: parametirl 
funcsiyas: funcsiyas 
parametri: parametri 
insan: insan 
terminalda: terminalda 
biri: biri 
olmas: olmas 
obyectl: obyectl 
klaslar: klaslar 
polifomism: polifomism 
enkapsulyasiya: enkapsulyasiya 
nisb: nisb 
obyektl: obyektl 
poliformasiya: poliformasiya 
el: el 
mentl: mentl 
yini: yini 
kontrol: kontrol 
olmur: olmur 
bundan: bundan 
elementl: elementl 
iki: iki 
halda: halda 
olabilir: olabilir 
gizli: gizli 
tic: tic 
asand: asand 
tip: tip 
zah: zah 
str: str 
tir: tir 
tipi: tipi 
byte: bytes 
bitl: bitl 
ard: ard 
ascii: ascii 
bit: bit 
list: list 
sonradan: sonradan 
rkibind: rkibind 
true: true 
tuple: tuple 
diril: diril 
dict: dict 
ibar: ibar 
qrup: qrup 
int: int 
tamam: tamam 
float: float 
qiqi: qiqi 
complex: complex 
kompleks: kompleks 
j: j js 
bool: bool 
ru: ru 
yanl: yanl 
false: false 
set: set 
ralanmam: ralanmam 
oxluq: oxluq 
duplikat: duplikat 
bilm: bilm 
available: available 
ing: ing 
historique: historique 
licence: licence 
introduction: introduction 
unix: unix 
programmer: programmers 
class: classes 
tutorial: tutorial 
functional: functional 
programming: programming 
howto: howto 
bare: bare 
url: url 
missing: missing 
title: title 
parameter: parameter 
ignored: ignored 
mw: mw 
parser: parser 
output: output 
cite: cite 
citation: citation 
font: font 
style: style 
inherit: inherit 
quote: quotes 
lock: lock 
free: free 
background: background 
upload: upload 
wikimedia: wikimedia 
wikipedia: wikipedia 
common: commons 
thumb: thumb 
green: green 
svg: svg 
px: px 
png: png 
repeat: repeat 
position: position 
right: right 
em: em 
center: center 
limited: limited 
registration: registration 
gray: gray 
alt: alt 
subscription: subscription 
aa: aa 
red: red 
color: color 
span: span 
border: border 
bottom: bottom 
dotted: dotted 
cursor: cursor 
help: help 
w: ws 
wikisource: wikisource 
logo: logo 
code: code 
padding: padding 
hidden: hidden 
error: error 
display: display 
none: none 
size: size 
visible: visible 
maint: maint 
margin: margin 
left: left 
format: format 
kern: kern 
wl: wl 
qayis: qayis 
xronologiya: xronologiya 
assembler: assembler 
basic: basic 
cobol: cobol 
fortran: fortran 
go: go 
javascript: javascript 
lua: lua 
objective: objective 
pascal: pascal 
php: php 
ruby: ruby 
smalltalk: smalltalk 
swift: swift 
visual: visual 
net: net 
vb: vb 
kateqoriya: kateqoriya 
lifba: lifba 
ra: ras 
newpp: newpp 
limit: limit 
report: report 
parsed: parsed 
cached: cached 
time: time 
cache: cache 
expiry: expiry 
reduced: reduced 
complication: complications 
vary: vary 
revision: revision 
sha: sha 
cpu: cpu 
usage: usage 
second: seconds 
real: real 
preprocessor: preprocessor 
visited: visited 
node: node 
count: count 
post: post 
expand: expand 
include: include 
template: template 
highest: highest 
expansion: expansion 
depth: depth 
expensive: expensive 
function: function 
unstrip: unstrip 
recursion: recursion 
memory: memory 
number: number 
wikibase: wikibase 
entity: entities 
loaded: loaded 
transclusion: transclusion 
m: ms 
call: calls 
total: total 
ablon: ablon 
karto: karto 
ka: ka 
wikidata: wikidata 
teql: teql 
sil: sil 
stinad: stinad 
web: web 
vikianbar: vikianbar 
navbox: navbox 
saved: saved 
key: key 
azwiki: azwiki 
pcache: pcache 
idhash: idhash 
canonical: canonical 
timestamp: timestamp 
id: id 
serialized: serialized 
json: json 
oldid: oldid 
kateqoriyalar: kateqoriyalar 
komp: komp 
ter: ter 
vikiveril: vikiveril 
naviqasiya: naviqasiya 
menyusu: menyusu 
