joseph: joseph 
jackson: jackson jacksons 
death: death 
family: family 
career: career 
biography: biography 
skip: skip 
main: main 
content: content 
people: people 
nostalgia: nostalgia 
celebrity: celebrity 
history: history 
culture: culture 
crime: crime 
scandal: scandal 
video: video videos 
contact: contact 
u: us u 
advertise: advertise 
privacy: privacy 
notice: notice 
term: terms 
use: use 
copyright: copyright 
policy: policy 
ad: ad 
choice: choices 
accessibility: accessibility 
support: support 
setting: settings 
february: february 
subscribe: subscribe 
newsletter: newsletter 
photo: photo 
denise: denise 
truscello: truscello 
wireimage: wireimage 
quick: quick 
fact: facts fact 
name: name 
birth: birth 
date: date 
july: july 
june: june 
place: place 
fountain: fountain 
hill: hill 
arkansas: arkansas 
la: las 
vega: vegas 
nevada: nevada 
early: early 
life: life lives 
starting: starting 
issue: issues issue 
personal: personal 
related: related 
cite: cite 
page: page 
publish: publish 
jul: jul 
comment: comment 
best: best 
known: known 
father: father 
international: international 
pop: pop 
superstar: superstar 
michael: michael 
rest: rest 
famous: famous 
born: born 
married: married 
katherine: katherine 
scruse: scruse 
together: together 
child: children child 
soon: soon 
noticed: noticed 
musical: musical 
talent: talent talents 
began: began 
acting: acting 
manager: manager 
group: group 
enjoyed: enjoyed 
success: success 
tension: tensions 
eventually: eventually 
led: led 
firing: firing 
son: son sons 
later: later 
accused: accused 
abuse: abuse 
sibling: sibling siblings 
confirmed: confirmed 
others: others 
denied: denied 
died: died 
battling: battling 
cancer: cancer 
walter: walter 
eldest: eldest 
five: five 
samuel: samuel 
high: high 
school: school 
teacher: teacher 
mother: mother 
crystal: crystal 
lee: lee 
king: king 
housewife: housewife 
couple: couple 
split: split 
moved: moved 
oakland: oakland 
california: california 
east: east 
chicago: chicago 
indiana: indiana 
lived: lived 
lonely: lonely 
childhood: childhood 
friend: friends 
turned: turned 
live: live 
near: near 
pursuing: pursuing 
dream: dreams 
becoming: becoming 
boxer: boxer 
found: found 
golden: golden 
glove: gloves 
preparing: preparing 
professional: professional 
athletic: athletic 
met: met 
year: years year 
old: old 
already: already 
time: time 
union: union 
quickly: quickly 
annuled: annuled 
november: november 
two: two 
bedroom: bedroom 
house: house 
gary: gary 
first: first 
maureen: maureen 
reilette: reilette 
rebbie: rebbie 
six: six 
month: months month 
may: may 
decided: decided 
leave: leave 
order: order 
work: work 
full: full 
crane: crane 
operator: operator 
steel: steel 
meantime: meantime 
wife: wife 
tended: tended 
growing: growing 
would: would 
go: go 
ten: ten 
brandon: brandon 
given: given 
still: still 
determined: determined 
make: make 
big: big 
mid: mid 
started: started 
band: band 
called: called 
falcon: falcons 
brother: brother brothers 
luther: luther 
failed: failed 
gain: gain 
notoriety: notoriety 
returned: returned 
job: job 
however: however 
caught: caught 
tito: tito 
playing: playing 
guitar: guitar 
jackie: jackie 
jermaine: jermaine 
formed: formed 
serving: serving 
entering: entering 
trio: trio 
local: local 
competition: competitions 
younger: younger 
marlon: marlon 
also: also 
involved: involved 
renamed: renamed 
gaining: gaining 
accolade: accolades 
r: r 
b: b 
circuit: circuit 
enforcing: enforcing 
long: long 
intense: intense 
rehearsal: rehearsals 
booked: booked 
respectable: respectable 
venue: venues 
landed: landed 
spot: spot 
renowned: renowned 
apollo: apollo 
theater: theater 
harlem: harlem 
new: new 
york: york 
amateur: amateur 
night: night 
contest: contest 
win: win 
earned: earned 
motown: motown 
record: record 
contract: contract 
immediate: immediate 
american: american 
four: four 
single: singles 
straight: straight 
billboard: billboard 
hot: hot 
chart: chart 
money: money 
managing: managing 
mansion: mansion 
encino: encino 
read: read 
next: next 
bella: bella 
hadid: hadid 
sadie: sadie 
alexander: alexander 
adrienne: adrienne 
kennedy: kennedy 
within: within 
caused: caused 
deep: deep 
rift: rifts 
strict: strict 
disciplinarian: disciplinarian 
report: reports 
abusive: abusive 
nature: nature 
leaking: leaking 
press: press 
fired: fired 
took: took 
control: control 
follow: follow 
suit: suit 
suffer: suffer 
publicly: publicly 
denounced: denounced 
another: another 
woman: woman 
gave: gave 
daughter: daughter 
filed: filed 
divorce: divorce 
twice: twice 
dropped: dropped 
case: cases 
spoke: spoke 
popular: popular 
oprah: oprah 
winfrey: winfrey 
show: show 
detailing: detailing 
physical: physical 
mental: mental 
endured: endured 
hand: hands 
throughout: throughout 
many: many 
claimed: claimed 
several: several 
never: never 
occurred: occurred 
suddenly: suddenly 
listed: listed 
guardian: guardian 
three: three 
received: received 
nothing: nothing 
estate: estate 
health: health 
rushed: rushed 
hospital: hospital 
brazil: brazil 
suffering: suffering 
stroke: stroke 
heart: heart 
arrhythmia: arrhythmia 
visiting: visiting 
country: country 
celebrate: celebrate 
th: th 
birthday: birthday 
treated: treated 
united: united 
state: states 
remained: remained 
frail: frail 
recovered: recovered 
previously: previously 
reportedly: reportedly 
admitted: admitted 
los: los 
angeles: angeles 
posted: posted 
message: message 
via: via 
publicist: publicist 
okay: okay 
reported: reported 
hospitalized: hospitalized 
terminal: terminal 
janet: janet 
subsequently: subsequently 
praised: praised 
honored: honored 
radio: radio 
disney: disney 
music: music 
award: awards 
calling: calling 
incredible: incredible 
morning: morning 
xa: xa 
nathan: nathan 
adelson: adelson 
hospice: hospice 
shy: shy 
deeply: deeply 
saddened: saddened 
mr: mr mrs 
passing: passing 
extend: extend 
heartfelt: heartfelt 
condolence: condolences 
said: said 
statement: statement 
executor: executors 
developed: developed 
warm: warm 
relationship: relationship 
joe: joe 
recent: recent 
miss: miss 
tremendously: tremendously 
tv: tv 
discovery: discovery 
mini: mini 
check: check 
strive: strive 
accuracy: accuracy 
fairness: fairness 
see: see 
something: something 
look: look 
right: right 
citation: citation 
information: information 
article: article 
title: title 
author: author 
com: com 
editor: editors 
website: website 
url: url 
access: access 
publisher: publisher 
e: e 
television: television 
network: networks 
last: last 
updated: updated 
april: april 
original: original 
published: published 
receive: receive 
story: stories 
shaped: shaped 
world: world 
sign: sign 
person: person 
multi: multi 
talented: talented 
entertainer: entertainer 
topping: topping 
solo: solo 
artist: artists artist 
released: released 
one: one 
selling: selling 
album: albums 
thriller: thriller 
number: number 
hit: hits hit 
bad: bad 
wall: wall 
paris: paris 
second: second 
legend: legend 
member: member 
prince: prince 
jr: jr 
nicknamed: nicknamed 
late: late 
star: star 
youngest: youngest 
contemporary: contemporary 
roster: roster 
includes: includes 
rhythm: rhythm 
nation: nation 
velvet: velvet 
rope: rope 
unbreakable: unbreakable 
randy: randy 
singer: singer 
musician: musician 
came: came 
fame: fame 
blanket: blanket 
ii: ii 
bigi: bigi 
third: third 
loading: loading 
logo: logo 
registered: registered 
trademark: trademarks 
llc: llc 
close: close 
