joe: joe 
biden: biden 
age: age ages 
politics: politics 
family: families family 
biography: biography 
skip: skip 
main: main 
content: content 
people: people 
nostalgia: nostalgia 
celebrity: celebrity 
history: history 
culture: culture 
crime: crimes crime 
scandal: scandal 
video: video 
contact: contact 
u: us u 
advertise: advertise 
privacy: privacy 
notice: notice 
term: term terms 
use: use 
copyright: copyright 
policy: policies policy 
ad: ad 
choice: choices 
accessibility: accessibility 
support: support 
setting: settings 
february: february 
subscribe: subscribe 
newsletter: newsletter 
photo: photos photo 
david: david 
lienemann: lienemann 
white: white 
house: house 
via: via 
getty: getty 
image: images 
quick: quick 
fact: facts fact 
name: name 
birth: birth 
date: date 
november: november 
education: education 
st: st 
helena: helena 
school: school schools 
paul: paul 
elementary: elementary 
university: university 
delaware: delaware 
archmere: archmere 
academy: academy 
syracuse: syracuse 
law: law laws 
place: place places 
scranton: scranton 
pennsylvania: pennsylvania 
full: full 
joseph: joseph 
robinette: robinette 
jr: jr 
zodiac: zodiac 
sign: sign 
scorpio: scorpio 
early: early 
year: years year 
college: college 
marriage: marriage 
political: political 
career: career 
tragedy: tragedy 
cite: cite 
page: page 
quote: quotes 
president: president 
asked: asked 
join: join 
ticket: ticket 
joked: joked 
said: said 
two: two 
condition: conditions 
one: one 
gonna: gonna 
wear: wear 
funny: funny 
hat: hats 
change: change 
brand: brand 
view: view views 
cannot: cannot 
conduct: conduct 
foreign: foreign 
extreme: extremes 
devastating: devastating 
punch: punch 
took: took 
september: september 
th: th 
still: still 
reverberates: reverberates 
throughout: throughout 
american: americans american 
society: society 
stock: stock 
market: market 
crashed: crashed 
franklin: franklin 
roosevelt: roosevelt 
got: got 
television: television 
talk: talk 
prince: princes 
greed: greed 
look: look 
happened: happened 
let: let 
smart: smart 
time: time 
looking: looking 
say: say 
talking: talking 
telling: telling 
go: go 
spend: spend 
money: money 
keep: keep 
going: going 
bankrupt: bankrupt 
answer: answer 
yes: yes 
started: started 
fighting: fighting 
civil: civil 
right: right rights 
part: part 
moment: moment 
best: best 
idea: ideas 
single: single 
reflection: reflection 
called: called 
upon: upon 
guy: guy 
incredible: incredible 
talent: talent 
also: also 
breakthrough: breakthrough 
figure: figure 
multiple: multiple 
way: way ways 
genuinely: genuinely 
find: find 
exciting: exciting 
new: new 
america: america 
hillary: hillary 
clinton: clinton 
qualified: qualified 
vice: vice 
quite: quite 
frankly: frankly 
might: might 
better: better 
pick: pick 
nobody: nobody 
owes: owes 
living: living 
everyone: everyone 
entitled: entitled 
dignity: dignity 
terrorist: terrorists 
win: win wins 
hate: hate 
stand: stand 
lead: leads lead 
example: example 
power: power 
get: get gets 
deer: deer 
three: three 
shot: shots 
hunting: hunting 
embarrassment: embarrassment 
think: think 
republican: republicans republican 
sort: sort 
mistrust: mistrust 
average: average 
middle: middle 
class: class 
little: little 
bit: bit 
like: like 
folk: folks 
know: know 
good: good 
want: want 
job: job jobs 
first: first 
would: would 
particularly: particularly 
partnership: partnership 
engaged: engaged 
used: used 
rewarding: rewarding 
found: found 
candor: candor 
generates: generates 
trust: trust 
sound: sounds sound 
corny: corny 
definition: definition 
ability: ability 
help: help 
publish: publish 
apr: apr 
comment: comment 
united: united 
state: state states 
served: served 
barack: barack 
obama: obama 
briefly: briefly 
worked: worked 
attorney: attorney 
turning: turning 
became: became 
fifth: fifth 
youngest: youngest 
senator: senators senator 
well: well 
longest: longest 
serving: serving 
presidential: presidential 
campaign: campaign 
never: never 
gained: gained 
momentum: momentum 
democratic: democratic 
nominee: nominee 
xa: xa 
selected: selected 
running: running 
mate: mate 
went: went 
serve: serve 
close: close closes 
administration: administration 
presented: presented 
medal: medal 
freedom: freedom 
later: later 
launched: launched 
elected: elected 
long: long 
reaching: reaching 
highest: highest 
office: offices office 
nation: nations nation 
born: born 
grew: grew 
blue: blue 
collar: collar 
city: city 
northeast: northeast 
father: father 
sr: sr 
cleaning: cleaning 
furnace: furnaces 
car: car 
salesman: salesman 
mother: mother 
catherine: catherine 
eugenia: eugenia 
jean: jean 
finnegan: finnegan 
credit: credits 
parent: parents 
instilling: instilling 
toughness: toughness 
hard: hard 
work: work 
perseverance: perseverance 
recalled: recalled 
frequently: frequently 
saying: saying 
champ: champ 
measure: measure 
man: man 
often: often 
knocked: knocked 
quickly: quickly 
come: come 
home: home 
sullen: sullen 
bullied: bullied 
bigger: bigger 
kid: kids kid 
neighborhood: neighborhood 
tell: tell 
bloody: bloody 
nose: nose 
walk: walk 
street: street 
next: next 
day: day days 
attended: attended 
old: old 
moved: moved 
mayfield: mayfield 
rapidly: rapidly 
growing: growing 
community: community 
sustained: sustained 
primarily: primarily 
nearby: nearby 
dupont: dupont 
chemical: chemical 
company: company 
child: children child 
struggled: struggled 
stutter: stutter 
dash: dash 
impedimenta: impedimenta 
mock: mock 
eventually: eventually 
overcame: overcame 
speech: speech 
impediment: impediment 
memorizing: memorizing 
passage: passage passages 
poetry: poetry 
reciting: reciting 
loud: loud 
front: front 
mirror: mirror 
acceptance: acceptance 
prestigious: prestigious 
although: although 
washing: washing 
window: windows window 
weeding: weeding 
garden: gardens garden 
afford: afford 
tuition: tuition 
dreamed: dreamed 
attending: attending 
object: object 
deepest: deepest 
desire: desire 
oz: oz 
solid: solid 
student: student 
despite: despite 
small: small 
size: size 
standout: standout 
receiver: receivers receiver 
football: football 
team: team 
skinny: skinny 
coach: coaches coach 
remembered: remembered 
pas: pass 
graduated: graduated 
studied: studied 
science: science 
played: played 
admit: admit 
spent: spent 
far: far 
interested: interested 
girl: girls 
party: party parties 
academic: academics 
developed: developed 
sharp: sharp 
interest: interest 
spurred: spurred 
inspiring: inspiring 
inauguration: inauguration 
john: john 
f: f 
kennedy: kennedy 
spring: spring 
break: break 
trip: trip 
bahamas: bahamas 
junior: junior 
met: met 
named: named 
neilia: neilia 
hunter: hunter 
word: words 
fell: fell 
as: ass 
tin: tin 
cup: cup 
love: love 
sight: sight 
encouraged: encouraged 
applied: applied 
fully: fully 
study: studies 
accepted: accepted 
graduation: graduation 
married: married 
mediocre: mediocre 
flunked: flunked 
failing: failing 
properly: properly 
reference: reference 
review: review 
article: article 
claimed: claimed 
accidental: accidental 
oversight: oversight 
incident: incident 
haunt: haunt 
album: album 
gallery: gallery 
graduating: graduating 
wilmington: wilmington 
begin: begin 
practicing: practicing 
firm: firm 
active: active 
member: member members 
castle: castle 
county: county 
council: council 
councilman: councilman 
addition: addition 
increasingly: increasingly 
busy: busy 
professional: professional 
life: life lives 
beau: beau 
robert: robert 
naomi: naomi 
amy: amy 
everything: everything 
happening: happening 
faster: faster 
expected: expected 
run: run 
popular: popular 
incumbent: incumbent 
j: j 
caleb: caleb 
boggs: boggs 
senate: senate 
thought: thought thoughts 
stood: stood 
chance: chance 
ran: ran 
tireless: tireless 
organized: organized 
mostly: mostly 
sister: sister 
valerie: valerie 
owen: owens 
manager: manager 
campaigned: campaigned 
daily: daily 
tight: tight 
race: race 
large: large 
turnout: turnout 
upset: upset 
victory: victories victory 
become: become 
wildest: wildest 
dream: dreams 
seemed: seemed 
coming: coming 
true: true 
struck: struck 
week: week weeks 
christmas: christmas 
wife: wife 
involved: involved 
terrible: terrible 
accident: accident 
shopping: shopping 
tree: tree 
killed: killed 
daughter: daughter 
severely: severely 
injured: injured 
son: son sons 
inconsolable: inconsolable 
even: even 
considered: considered 
suicide: suicide 
recall: recalls 
began: began 
understand: understand 
despair: despair 
led: led 
cash: cash 
option: option 
rational: rational 
felt: felt 
god: god 
horrible: horrible 
trick: trick 
angry: angry 
nevertheless: nevertheless 
encouragement: encouragement 
decided: decided 
honor: honor 
commitment: commitment 
representing: representing 
skipped: skipped 
swearing: swearing 
ceremony: ceremony 
washington: washington 
instead: instead 
oath: oath 
hospital: hospital 
room: room 
order: orders order 
much: much 
possible: possible 
continue: continue 
live: live 
commuting: commuting 
amtrak: amtrak 
train: train 
practice: practice 
maintained: maintained 
entire: entire 
tenure: tenure 
read: read 
heartbreaking: heartbreaking 
distinguished: distinguished 
respect: respect 
body: body 
leading: leading 
expert: experts 
chairman: chairman 
committee: committee 
relation: relations 
several: several 
many: many 
position: position positions 
included: included 
advocating: advocating 
strategic: strategic 
arm: arms 
limitation: limitation 
soviet: soviet 
union: union 
promoting: promoting 
peace: peace 
stability: stability 
balkan: balkans 
expanding: expanding 
nato: nato 
include: include 
former: former 
bloc: bloc 
opposing: opposing 
gulf: gulf 
war: war 
action: actions action 
end: end 
genocide: genocide 
darfur: darfur 
spoke: spoke 
george: george 
w: w 
bush: bush 
handling: handling 
iraq: iraq 
troop: troop 
surge: surge 
outspoken: outspoken 
proponent: proponent 
tougher: tougher 
supreme: supreme 
court: court 
bork: bork 
failure: failure 
receive: receive 
confirmation: confirmation 
largely: largely 
attributed: attributed 
harsh: harsh 
questioning: questioning 
judiciary: judiciary 
sponsored: sponsored 
violent: violent 
control: control 
enforcement: enforcement 
act: act 
add: add 
police: police 
officer: officers 
increase: increases increase 
sentence: sentences 
host: host 
ambition: ambitions 
established: established 
prominent: prominent 
lawmaker: lawmakers 
presidency: presidency 
dropped: dropped 
primary: primary 
however: however 
report: reports 
surfaced: surfaced 
plagiarized: plagiarized 
suffering: suffering 
severe: severe 
headache: headaches 
shortly: shortly 
doctor: doctors 
discovered: discovered 
threatening: threatening 
brain: brain 
aneurysm: aneurysms 
complication: complications 
ensuing: ensuing 
surgery: surgery 
blood: blood 
clot: clots 
lung: lungs 
turn: turn 
caused: caused 
undergo: undergo 
another: another 
always: always 
resilient: resilient 
returned: returned 
surviving: surviving 
seven: seven 
month: months month 
recovery: recovery 
period: period 
unsuccessful: unsuccessful 
bid: bid 
experience: experience 
failed: failed 
generate: generate 
field: field 
dominated: dominated 
receiving: receiving 
le: less 
percent: percent 
vote: vote votes 
crucial: crucial 
iowa: iowa 
caucus: caucuses 
though: though 
secured: secured 
nomination: nomination 
fought: fought 
working: working 
root: roots 
helped: helped 
communicate: communicate 
message: message 
economic: economic 
voter: voters voter 
swing: swing 
ohio: ohio 
convincingly: convincingly 
defeated: defeated 
arizona: arizona 
mccain: mccain 
alaska: alaska 
governor: governor 
sarah: sarah 
palin: palin 
january: january 
sworn: sworn 
role: roles role 
behind: behind 
scene: scenes 
adviser: adviser 
formulating: formulating 
federal: federal 
relating: relating 
afghanistan: afghanistan 
connection: connections 
secure: secure 
reduction: reduction 
treaty: treaty 
russian: russian 
federation: federation 
relish: relish 
opportunity: opportunity 
play: play 
following: following 
election: election 
historic: historic 
second: second 
faced: faced 
challenger: challenger 
mitt: mitt 
romney: romney 
massachusetts: massachusetts 
representative: representatives representative 
ryan: ryan 
wisconsin: wisconsin 
earning: earning 
received: received 
nearly: nearly 
electoral: electoral 
million: million 
ballot: ballot ballots 
showed: showed 
influential: influential 
could: could 
instrumental: instrumental 
achieving: achieving 
bipartisan: bipartisan 
agreement: agreement 
tax: tax 
spending: spending 
cut: cuts 
avoid: avoid 
fiscal: fiscal 
cliff: cliff 
crisis: crisis 
looming: looming 
deadline: deadline 
able: able 
hammer: hammer 
deal: deal 
minority: minority 
leader: leader 
mitch: mitch 
mcconnell: mcconnell 
bill: bill 
passed: passed 
tough: tough 
negotiation: negotiations 
approved: approved 
around: around 
national: national 
debate: debates debate 
gun: gun 
head: head 
special: special 
task: task 
force: force 
issue: issue 
shooting: shooting 
newtown: newtown 
connecticut: connecticut 
december: december 
delivered: delivered 
solution: solutions 
reducing: reducing 
violence: violence 
across: across 
craft: craft 
take: take 
using: using 
executive: executive 
among: among 
recommendation: recommendations 
personal: personal 
post: post 
jill: jill 
since: since 
couple: couple 
ashley: ashley 
may: may 
suffered: suffered 
loss: loss 
died: died 
battling: battling 
cancer: cancer 
simply: simply 
finest: finest 
ever: ever 
known: known 
wrote: wrote 
statement: statement 
inside: inside 
unbreakable: unbreakable 
bond: bond 
put: put 
speculation: speculation 
rest: rest 
october: october 
announced: announced 
seek: seek 
rose: rose 
side: sides side 
made: made 
announcement: announcements announcement 
referring: referring 
recent: recent 
death: death deaths 
decision: decision 
making: making 
grieving: grieving 
process: process 
along: along 
others: others 
concluded: concluded 
closed: closed 
added: added 
candidate: candidates candidate 
silent: silent 
intend: intend 
speak: speak 
clearly: clearly 
forcefully: forcefully 
influence: influence 
need: need 
distinction: distinction 
civilian: civilian 
surprise: surprise 
lion: lion 
told: told 
honored: honored 
faith: faith 
fellow: fellow 
country: country 
lifetime: lifetime 
service: services service 
endure: endure 
generation: generations 
gave: gave 
emotional: emotional 
impromptu: impromptu 
thanking: thanking 
lady: lady 
michelle: michelle 
promised: promised 
refused: refused 
remain: remain 
quiet: quiet 
leaving: leaving 
opposition: opposition 
successor: successor 
donald: donald 
trump: trump 
occasionally: occasionally 
criticize: criticize 
event: event 
declared: declared 
governance: governance 
blasted: blasted 
seeming: seeming 
defense: defense 
nationalist: nationalist 
group: groups 
bella: bella 
hadid: hadid 
sadie: sadie 
alexander: alexander 
adrienne: adrienne 
additionally: additionally 
revealed: revealed 
mixed: mixed 
feeling: feelings 
bypassing: bypassing 
march: march 
elaborated: elaborated 
interview: interview 
oprah: oprah 
winfrey: winfrey 
woman: woman women 
announce: announce 
unless: unless 
question: questions 
truly: truly 
believe: believe 
person: person 
believed: believed 
prepared: prepared 
give: give 
whole: whole 
heart: heart 
soul: soul 
intention: intention 
endeavor: endeavor 
knew: knew 
show: show 
publicized: publicized 
interaction: interaction 
co: co 
meghan: meghan 
whose: whose 
dad: dad 
diagnosed: diagnosed 
visibly: visibly 
discussing: discussing 
disease: disease 
vp: vp 
gently: gently 
hand: hand 
console: console 
pointing: pointing 
inspired: inspired 
courage: courage 
hope: hope 
anybody: anybody 
make: make 
al: al 
sharpton: sharpton 
ruled: ruled 
recovered: recovered 
enough: enough 
devote: devote 
effort: effort efforts 
really: really 
hoping: hoping 
step: step 
away: away 
knowing: knowing 
somebody: somebody 
result: results 
harvard: harvard 
cap: cap caps 
harris: harris 
poll: polls poll 
june: june 
suggested: suggested 
democrat: democrats 
ready: ready 
yet: yet 
topped: topped 
participant: participants 
naming: naming 
favorite: favorite 
came: came 
bernie: bernie 
sander: sanders 
finishing: finishing 
third: third 
contemplating: contemplating 
problem: problem 
lucy: lucy 
flores: flores 
nevada: nevada 
assemblywoman: assemblywoman 
published: published 
essay: essay 
described: described 
inappropriately: inappropriately 
kissing: kissing 
responded: responded 
countless: countless 
handshake: handshakes 
hug: hugs 
expression: expressions 
affection: affection 
comfort: comfort 
offered: offered 
ally: allies 
adding: adding 
acted: acted 
listen: listen 
respectfully: respectfully 
congressional: congressional 
aide: aide 
lappos: lappos 
forward: forward 
story: story stories 
uncomfortable: uncomfortable 
fundraiser: fundraiser 
indicating: indicating 
likely: likely 
linger: linger 
april: april 
news: news 
minute: minute 
referenced: referenced 
attempt: attempt attempts 
equate: equate 
racially: racially 
charged: charged 
clash: clash 
charlottesville: charlottesville 
virginia: virginia 
threat: threat 
unlike: unlike 
seen: seen 
easily: easily 
entered: entered 
candidacy: candidacy 
soon: soon 
litmus: litmus 
test: test 
progressive: progressive 
base: base 
underscoring: underscoring 
challenge: challenge challenges 
presenting: presenting 
moderate: moderate 
drew: drew 
criticism: criticism 
affirming: affirming 
hyde: hyde 
amendment: amendment 
banned: banned 
funding: funding 
abortion: abortions 
reversing: reversing 
afterward: afterward 
late: late 
track: track 
record: record 
targeted: targeted 
kamala: kamala 
busing: busing 
mean: means 
integrating: integrating 
fared: fared 
subsequent: subsequent 
demonstrated: demonstrated 
grasp: grasp 
tied: tied 
accomplishment: accomplishments 
meanwhile: meanwhile 
revelation: revelation 
pressured: pressured 
ukrainian: ukrainian 
government: government 
investigating: investigating 
stemmed: stemmed 
involvement: involvement 
energy: energy 
burisma: burisma 
holding: holdings 
prosecutor: prosecutor 
general: general 
fired: fired 
abuse: abuse 
impeachment: impeachment 
cooperate: cooperate 
congress: congress 
topic: topic 
additional: additional 
urgency: urgency 
speaker: speaker 
nancy: nancy 
pelosi: pelosi 
ignited: ignited 
proceeding: proceedings 
trial: trial 
ended: ended 
acquittal: acquittal 
finished: finished 
fourth: fourth 
hampshire: hampshire 
rebounded: rebounded 
resounding: resounding 
south: south 
carolina: carolina 
continued: continued 
claiming: claiming 
majority: majority 
delegate: delegates 
super: super 
tuesday: tuesday 
voting: voting 
driving: driving 
top: top 
competitor: competitors 
mid: mid 
committed: committed 
nominating: nominating 
presumptive: presumptive 
facing: facing 
allegation: allegations 
sexual: sexual 
assault: assault 
tara: tara 
reade: reade 
august: august 
great: great 
picked: picked 
fearless: fearless 
fighter: fighter 
public: public 
servant: servants 
back: back 
closely: closely 
watched: watched 
big: big 
bank: banks 
lifted: lifted 
protected: protected 
proud: proud 
partner: partner 
officially: officially 
anticipated: anticipated 
messy: messy 
affair: affair 
marked: marked 
frequent: frequent 
interruption: interruptions 
heated: heated 
discussion: discussions 
spiraled: spiraled 
flustered: flustered 
opponent: opponent 
clown: clown 
managed: managed 
coronavirus: coronavirus 
pandemic: pandemic 
emphatically: emphatically 
climate: climate 
scheduled: scheduled 
declined: declined 
virtual: virtual 
town: town 
hall: halls 
microphone: microphones 
muted: muted 
fewer: fewer 
articulated: articulated 
health: health 
care: care 
immigration: immigration 
overhaul: overhaul 
green: green 
unloaded: unloaded 
management: management 
separating: separating 
migrant: migrant migrants 
border: border 
drawing: drawing 
clear: clear 
style: styles 
declaration: declaration 
character: character 
counting: counting 
mail: mail 
past: past 
polling: polling 
remained: remained 
call: call 
tide: tide 
shifting: shifting 
favor: favor 
michigan: michigan 
georgia: georgia 
series: series 
lawsuit: lawsuits 
alleged: alleged 
fraud: fraud 
sought: sought 
halt: halt 
battleground: battleground 
four: four 
elect: elect 
winning: winning 
plus: plus 
set: set 
oldest: oldest 
chosen: chosen 
tweeted: tweeted 
ahead: ahead 
promise: promise 
whether: whether 
voted: voted 
placed: placed 
elector: electors 
cast: cast 
formalizing: formalizing 
selection: selection 
cabinet: cabinet 
staffer: staffers 
initially: initially 
transition: transition 
thwarted: thwarted 
emily: emily 
murphy: murphy 
release: release 
fund: funds 
capitol: capitol 
siege: siege 
start: start 
session: session 
formalize: formalize 
mob: mob 
supporter: supporters 
stormed: stormed 
building: building 
overwhelmed: overwhelmed 
forcing: forcing 
evacuate: evacuate 
safety: safety 
pleaded: pleaded 
chaos: chaos 
inspire: inspire 
worst: worst 
incite: incite 
therefore: therefore 
fulfill: fulfill 
defend: defend 
constitution: constitution 
demand: demand 
resulted: resulted 
arrest: arrests 
five: five 
resumed: resumed 
midnight: midnight 
mike: mike 
penny: pence 
formally: formally 
announcing: announcing 
democracy: democracy 
renewal: renewal 
resolve: resolve 
crucible: crucible 
tested: tested 
anew: anew 
risen: risen 
today: today 
celebrate: celebrate 
triumph: triumph 
cause: cause 
heard: heard 
heeded: heeded 
learned: learned 
precious: precious 
fragile: fragile 
hour: hour 
friend: friends 
prevailed: prevailed 
opening: opening 
inaugural: inaugural 
address: address 
getting: getting 
signed: signed 
flurry: flurry 
reversed: reversed 
predecessor: predecessor 
paris: paris 
overturned: overturned 
ban: ban 
traveler: travelers 
muslim: muslim 
pulled: pulled 
construction: construction 
wall: wall 
mexican: mexican 
revoked: revoked 
permit: permit 
keystone: keystone 
xl: xl 
pipeline: pipeline 
allowed: allowed 
transgender: transgender 
military: military 
reeling: reeling 
covid: covid 
enacted: enacted 
expanded: expanded 
enrollment: enrollment 
insurance: insurance 
marketplace: marketplace 
urged: urged 
relief: relief 
package: package 
fruition: fruition 
rescue: rescue 
plan: plan 
light: light 
round: round 
stimulus: stimulus 
payment: payments 
extended: extended 
unemployment: unemployment 
benefit: benefits 
eligible: eligible 
vaccine: vaccine 
celebrated: celebrated 
administering: administering 
dos: doses 
target: target 
tie: tie 
proposal: proposals 
trillion: trillion 
aimed: aimed 
overdue: overdue 
infrastructure: infrastructure 
investment: investment investments 
establish: establish 
publicly: publicly 
funded: funded 
preschool: preschools 
comprehensive: comprehensive 
medical: medical 
leave: leave 
program: program 
presence: presence 
withdrawn: withdrawn 
hit: hit 
russia: russia 
extensive: extensive 
sanction: sanctions 
hacking: hacking 
operation: operation 
breached: breached 
agency: agencies 
saw: saw 
positive: positive 
reunite: reunite 
displaced: displaced 
pledged: pledged 
metering: metering 
limited: limited 
number: number 
asylum: asylum 
seeker: seekers 
ease: ease 
overcrowded: overcrowded 
detention: detention 
center: centers 
mexico: mexico 
reneged: reneged 
raise: raise 
era: era 
refugee: refugees 
pushback: pushback 
forced: forced 
reconsider: reconsider 
stance: stance 
check: check 
strive: strive 
accuracy: accuracy 
fairness: fairness 
see: see 
something: something 
citation: citation 
information: information 
title: titles title 
author: author 
com: com 
editor: editors 
website: website 
url: url 
access: access 
publisher: publisher 
e: e 
network: networks 
last: last 
updated: updated 
original: original 
shaped: shaped 
world: world 
guard: guard 
lawyer: lawyer 
banker: banker 
african: african 
dimaggio: dimaggio 
baseball: baseball 
legend: legend 
game: game 
hitting: hitting 
streak: streak 
nine: nine 
york: york 
yankee: yankees 
paterno: paterno 
successful: successful 
collegiate: collegiate 
reputation: reputation 
marred: marred 
sex: sex 
dismissal: dismissal 
montana: montana 
player: player 
er: ers 
bowl: bowls 
including: including 
consecutive: consecutive 
namath: namath 
nicknamed: nicknamed 
broadway: broadway 
quarterback: quarterback 
season: season 
jet: jets 
threw: threw 
yard: yards 
loading: loading 
logo: logo 
registered: registered 
trademark: trademarks 
llc: llc 
