berry: berry 
gordy: gordy 
jr: jr 
son: son 
age: age ages 
song: song songs 
biography: biography 
skip: skip 
main: main 
content: content 
people: people 
nostalgia: nostalgia 
celebrity: celebrity 
history: history 
culture: culture 
crime: crime 
scandal: scandal 
video: video 
contact: contact 
u: us u 
advertise: advertise 
privacy: privacy 
notice: notice 
term: terms 
use: use 
copyright: copyright 
policy: policy 
ad: ad 
choice: choices 
accessibility: accessibility 
support: support 
setting: settings 
february: february 
subscribe: subscribe 
newsletter: newsletter 
photo: photo 
steve: steve 
granitz: granitz 
wireimage: wireimage 
quick: quick 
fact: facts fact 
name: name names 
birth: birth 
date: date 
november: november 
place: place 
detroit: detroit 
michigan: michigan 
zodiac: zodiac 
sign: sign 
sagittarius: sagittarius 
cite: cite 
page: page 
quote: quotes 
motown: motown 
educated: educated 
control: control 
emotion: emotions 
hear: hear 
make: makes 
dance: dance 
sing: sing 
happy: happy 
sad: sad 
publish: publish 
apr: apr 
comment: comment 
founded: founded 
record: record records 
propelled: propelled 
group: groups group 
like: like 
supremes: supremes 
success: success 
became: became 
largest: largest 
black: black 
owned: owned 
company: company 
united: united 
state: states 
saw: saw 
popular: popular 
artist: artists 
developed: developed 
including: including 
jackson: jackson 
stevie: stevie 
wonder: wonder 
marvin: marvin 
gaye: gaye 
xa: xa 
dominate: dominate 
music: music 
scene: scene 
changing: changing 
taste: tastes 
loss: loss 
focus: focus 
led: led 
decline: decline 
sold: sold 
inducted: inducted 
rock: rock 
roll: roll 
hall: hall 
fame: fame 
year: years year 
early: early 
life: life lives 
work: work 
born: born 
seventh: seventh 
eight: eight 
child: children 
close: close 
knit: knit 
hardworking: hardworking 
family: family 
unlike: unlike 
sibling: siblings 
struggled: struggled 
school: school 
loved: loved 
interested: interested 
songwriting: songwriting 
kicked: kicked 
high: high 
class: class 
dropped: dropped 
order: order 
pursue: pursue 
boxing: boxing 
career: career careers 
time: time 
triumphed: triumphed 
professional: professional 
fight: fights 
however: however 
realization: realization 
would: would 
much: much 
faster: faster 
prompted: prompted 
return: return 
plan: plans 
interrupted: interrupted 
drafted: drafted 
army: army 
two: two 
earned: earned 
ged: ged 
opened: opened 
store: store 
friend: friend friends 
unfortunately: unfortunately 
focused: focused 
jazz: jazz 
customer: customers 
wanted: wanted 
r: r 
b: b 
realized: realized 
late: late 
keep: keep 
business: business 
folding: folding 
money: money 
gotten: gotten 
married: married 
took: took 
job: job 
lincoln: lincoln 
mercury: mercury 
plant: plant 
assembly: assembly 
line: line 
monotony: monotony 
putting: putting 
upholstery: upholstery 
car: cars 
day: day 
one: one 
benefit: benefit 
could: could 
compose: compose 
head: head 
working: working 
decided: decided 
hand: hand 
dedicate: dedicate 
wife: wife 
approve: approve 
ended: ended 
separating: separating 
connection: connections 
encountered: encountered 
singer: singer 
jackie: jackie 
wilson: wilson 
manager: manager 
co: co 
writing: writing 
hit: hits hit 
reet: reet 
petite: petite 
came: came 
also: also 
wrote: wrote 
lonely: lonely 
teardrop: teardrops 
x: x 
soon: soon 
started: started 
publishing: publishing 
called: called 
jobete: jobete 
combination: combination 
letter: letters 
three: three 
lucrative: lucrative 
hoped: hoped 
therefore: therefore 
open: open 
beginning: beginnings 
using: using 
loaned: loaned 
formed: formed 
tamla: tamla 
january: january 
set: set 
shop: shop 
house: house 
west: west 
grand: grand 
boulevard: boulevard 
chose: chose 
aspirational: aspirational 
hitsville: hitsville 
headquarters: headquarters 
label: label labels 
embody: embody 
corporation: corporation 
incorporated: incorporated 
want: want 
performed: performed 
written: written 
barrett: barrett 
strong: strong 
serving: serving 
writer: writer 
well: well wells 
discovering: discovering 
distributor: distributors 
large: large 
bite: bite 
income: income 
encouraged: encouraged 
smokey: smokey 
robinson: robinson 
start: start 
handling: handling 
national: national 
distribution: distribution 
miracle: miracles 
million: million 
copy: copies 
around: around 
climbed: climbed 
chart: charts 
pop: pop 
next: next 
marvelettes: marvelettes 
first: first 
act: act 
please: please 
mr: mr 
postman: postman 
shape: shape 
brought: brought 
talent: talent 
mary: mary 
guy: guy 
hire: hires 
temptation: temptations 
onboard: onboard 
old: old 
prodigy: prodigy 
signed: signed 
teenage: teenage 
girl: girls girl 
florence: florence 
ballard: ballard 
diana: diana 
ross: ross 
become: become 
industry: industry 
directed: directed 
create: create 
known: known 
sound: sound 
featured: featured 
repeating: repeating 
chorus: choruses 
mix: mix 
gospel: gospel 
combined: combined 
form: form 
memorable: memorable 
melody: melodies 
regular: regular 
quality: quality 
meeting: meetings 
made: made 
sure: sure 
release: release releases 
ready: ready 
impress: impress 
listener: listeners 
arranged: arranged 
performer: performers 
learn: learn 
best: best 
present: present 
stage: stage 
civil: civil 
right: right rights 
movement: movement 
affected: affected 
martin: martin 
luther: luther 
king: king 
great: great 
march: march 
freedom: freedom 
washington: washington 
speech: speeches 
believed: believed 
white: white 
audience: audiences 
accept: accept 
african: african 
american: american 
star: stars 
achieved: achieved 
kind: kind 
crossover: crossover 
dreamed: dreamed 
included: included 
baby: baby 
love: love 
stop: stop 
hurry: hurry 
sale: sale sales 
triple: triple 
making: making 
onto: onto 
five: five 
top: tops top 
fronted: fronted 
young: young 
michael: michael 
joined: joined 
read: read 
bella: bella 
hadid: hadid 
sadie: sadie 
alexander: alexander 
adrienne: adrienne 
kennedy: kennedy 
america: america 
dominance: dominance 
able: able 
integrate: integrate 
department: department 
clout: clout 
demand: demand 
force: force 
accepted: accepted 
across: across 
country: country 
problem: problems 
bought: bought 
home: home 
southern: southern 
california: california 
later: later 
officially: officially 
moved: moved 
los: los 
angeles: angeles 
produced: produced 
lady: lady 
sings: sings 
blue: blue blues 
biopic: biopic 
billie: billie 
holiday: holiday 
starred: starred 
along: along 
richard: richard 
pryor: pryor 
despite: despite 
budget: budget 
overrun: overruns 
film: film films 
garnering: garnering 
academy: academy 
award: award 
nomination: nominations 
worked: worked 
directing: directing 
mahogany: mahogany 
starring: starring 
billy: billy 
dee: dee 
williams: williams 
anthony: anthony 
perkins: perkins 
producing: producing 
commercially: commercially 
unsuccessful: unsuccessful 
musical: musical 
wiz: wiz 
nipsey: nipsey 
russell: russell 
lena: lena 
horne: horne 
interest: interest 
movie: movies 
meant: meant 
le: less 
pay: pay 
attention: attention 
side: side 
thing: things 
going: going 
powerful: powerful 
protest: protest 
album: album 
notable: notable 
renewed: renewed 
contract: contract 
receiving: receiving 
new: new 
commodore: commodores 
featuring: featuring 
lionel: lionel 
richie: richie 
rick: rick 
james: james 
debarge: debarge 
many: many 
established: established 
growing: growing 
restless: restless 
labor: labor 
everything: everything 
done: done 
often: often 
favor: favor 
charged: charged 
studio: studio 
songwriter: songwriters songwriter 
hired: hired 
employee: employees 
retaining: retaining 
ownership: ownership 
defended: defended 
door: doors 
feeling: feeling 
ill: ill 
used: used 
team: team 
brian: brian 
holland: holland 
lamont: lamont 
dozier: dozier 
eddie: eddie 
responsible: responsible 
slew: slew 
ruptured: ruptured 
leading: leading 
lawsuit: lawsuits 
gladys: gladys 
knight: knight 
pip: pips 
four: four 
left: left 
cbs: cbs 
jermaine: jermaine 
daughter: daughter 
hazel: hazel 
stayed: stayed 
know: know 
famous: famous 
got: got 
world: world 
fallen: fallen 
standing: standing 
blowout: blowouts 
supporting: supporting 
solo: solo 
revealed: revealed 
couple: couple 
rhonda: rhonda 
walked: walked 
away: away 
longer: longer 
item: item 
still: still 
blow: blow 
selling: selling 
mca: mca 
departure: departure 
shift: shift 
sell: sell 
held: held 
television: television 
production: production 
arm: arm 
received: received 
half: half 
mountain: mountain 
enough: enough 
sunshine: sunshine 
though: though 
lost: lost 
position: position 
enterprise: enterprise 
community: community 
upset: upset 
iconic: iconic 
felt: felt 
way: way 
ensure: ensure 
survival: survival 
legacy: legacy 
play: play 
instrument: instrument 
chop: chops 
promote: promote 
incredible: incredible 
roster: roster 
dubbed: dubbed 
output: output 
today: today 
beloved: beloved 
globe: globe 
green: green 
cop: cops 
robber: robbers 
autobiography: autobiography 
magic: magic 
memory: memories 
released: released 
book: book 
reached: reached 
broadway: broadway 
show: show 
closed: closed 
tour: tour 
continues: continues 
museum: museum 
section: section 
consists: consists 
joy: joy 
iv: iv 
terry: terry 
kerry: kerry 
sherry: sherry 
stefan: stefan 
september: september 
president: president 
barack: barack 
obama: obama 
honored: honored 
among: among 
cultural: cultural 
icon: icons 
medal: medal 
art: arts 
ceremony: ceremony 
spoke: spoke 
contribution: contribution 
saying: saying 
helped: helped 
trailblazing: trailblazing 
producer: producer 
build: build 
launching: launching 
countless: countless 
legendary: legendary 
unique: unique 
nation: nations nation 
story: story stories 
check: check 
strive: strive 
accuracy: accuracy 
fairness: fairness 
see: see 
something: something 
look: look 
citation: citation 
information: information 
article: article 
title: title 
author: author 
sara: sara 
kettler: kettler 
website: website 
com: com 
url: url 
access: access 
publisher: publisher 
e: e 
network: networks 
last: last 
updated: updated 
august: august 
original: original 
published: published 
april: april 
receive: receive 
shaped: shaped 
person: person 
delivered: delivered 
actress: actress 
part: part 
soul: soul 
trio: trio 
embarking: embarking 
successful: successful 
whitney: whitney 
leader: leader 
urban: urban 
league: league 
forefront: forefront 
racial: racial 
integration: integration 
economic: economic 
empowerment: empowerment 
scholar: scholar 
minister: minister 
assassination: assassination 
memorialized: memorialized 
addressed: addressed 
controversial: controversial 
theme: themes 
sammy: sammy 
davis: davis 
highly: highly 
actor: actor 
comedian: comedian 
dancer: dancer 
rat: rat 
pack: pack 
frank: frank 
sinatra: sinatra 
dean: dean 
several: several 
hank: hank 
namesake: namesake 
pioneer: pioneer 
style: style 
andrew: andrew 
activist: activist 
alongside: alongside 
member: member 
congress: congress 
mayor: mayor 
atlanta: atlanta 
ambassador: ambassador 
tom: tom 
selleck: selleck 
portraying: portraying 
thomas: thomas 
magnum: magnum 
series: series 
p: p 
include: include 
men: men 
loading: loading 
logo: logo 
registered: registered 
trademark: trademarks 
llc: llc 
