help: help 
category: categories category 
good: good 
article: articles article 
wikipedia: wikipedia 
free: free 
encyclopedia: encyclopedia 
jump: jump 
navigation: navigation 
search: search 
tracking: tracking 
used: used 
build: build 
maintain: maintain 
list: list lists 
page: pages page 
primarily: primarily 
sake: sake 
use: use 
maintenance: maintenance 
part: part 
categorization: categorization 
scheme: scheme 
information: information 
hidden: hidden 
member: members member 
unless: unless 
corresponding: corresponding 
user: user 
preference: preference 
set: set 
track: track 
organize: organize 
needing: needing 
attention: attention 
en: en 
masse: masse 
example: example 
using: using 
deprecated: deprecated 
syntax: syntax 
may: may 
need: need 
edited: edited 
someone: someone 
earliest: earliest 
convenience: convenience 
also: also 
serve: serve 
aggregate: aggregate 
several: several 
sub: sub 
larger: larger 
efficient: efficient 
discriminated: discriminated 
classification: classifications 
hold: holds 
exists: exists 
among: among 
reason: reasons 
enable: enable 
pagesincategory: pagesincategory 
give: give 
number: number 
given: given 
slightly: slightly 
different: different 
transcluding: transcluding 
included: included 
add: add 
mw: mw 
parser: parser 
output: output 
hatnote: hatnote 
font: font 
style: style 
italic: italic 
div: div 
padding: padding 
left: left 
em: em 
margin: margin 
bottom: bottom 
normal: normal 
link: link 
top: top 
see: see 
random: random 
large: large 
cat: cat 
toc: toc 
box: box 
sizing: sizing 
border: border 
display: display 
block: block 
clear: clear 
body: body 
text: text 
align: align 
center: center 
scroll: scroll 
overflow: overflow 
x: x 
white: white 
space: space 
nowrap: nowrap 
collapsible: collapsible 
px: px 
solid: solid 
b: b 
size: size 
content: content contents 
background: background 
color: color 
family: family 
monospace: monospace 
span: span 
eaecf: eaecf 
jumpy: jumpy 
title: title 
toctitle: toctitle 
anum: anum 
weight: weight 
bold: bold 
c: c 
e: e 
f: f 
g: g 
h: h 
j: j 
k: k 
l: l 
n: n 
p: p 
q: q 
r: r 
u: u 
v: vs v 
w: w 
z: z 
aa: aa 
ae: ae 
aj: aj 
ao: ao 
ba: ba 
bj: bj 
bo: bo 
bt: bt 
ca: ca 
ce: ce 
cj: cj 
co: co 
ct: ct 
da: da 
de: de 
dj: dj 
dt: dt 
ea: ea 
ee: ee 
ej: ej 
eo: eo 
et: et 
fa: fa 
fe: fe 
fj: fj 
fo: fo 
ft: ft 
ga: ga 
ge: ge 
gj: gj 
go: go 
gt: gt 
ha: ha 
hj: hj 
ho: ho 
ht: ht 
ia: ia 
ie: ie 
ij: ij 
io: io 
ja: ja 
je: je 
jj: jj 
jo: jo 
jt: jt 
ka: ka 
ke: ke 
kj: kj 
ko: ko 
kt: kt 
la: la 
le: le 
lj: lj 
lo: lo 
lt: lt 
mj: mj 
mo: mo 
mt: mt 
na: na 
ne: ne 
nj: nj 
nt: nt 
oa: oa 
oe: oe 
oj: oj 
oo: oo 
ot: ot 
pa: pa 
pe: pe 
pj: pj 
po: po 
pt: pt 
qa: qa 
qe: qe 
qj: qj 
qo: qo 
qt: qt 
ra: ra 
rj: rj 
ro: ro 
rt: rt 
sa: sas sa 
se: se 
sj: sj 
st: st 
ta: ta 
te: te 
tj: tj 
tt: tt 
ua: ua 
ue: ue 
uj: uj 
uo: uo 
ut: ut 
va: va 
vj: vj 
vo: vo 
vt: vt 
wa: wa 
wj: wj 
wo: wo 
wt: wt 
xa: xa 
xe: xe 
xj: xj 
xo: xo 
xt: xt 
ya: ya 
ye: ye 
yj: yj 
yo: yo 
yt: yt 
za: za 
ze: ze 
zj: zj 
zo: zo 
zt: zt 
newpp: newpp 
limit: limit 
report: report 
parsed: parsed 
cached: cached 
time: time times 
cache: cache 
expiry: expiry 
reduced: reduced 
false: false 
complication: complications 
cpu: cpu 
usage: usage 
second: seconds 
real: real 
preprocessor: preprocessor 
visited: visited 
node: node 
count: count 
post: post 
expand: expand 
include: include 
byte: bytes 
template: template 
argument: argument 
highest: highest 
expansion: expansion 
depth: depth 
expensive: expensive 
function: function 
unstrip: unstrip 
recursion: recursion 
lua: lua 
memory: memory 
wikibase: wikibase 
entity: entities 
loaded: loaded 
transclusion: transclusion 
m: ms 
call: calls 
total: total 
cmbox: cmbox 
catautotoc: catautotoc 
core: core 
single: single 
namespace: namespace 
tlx: tlx 
saved: saved 
key: key 
enwiki: enwiki 
pcache: pcache 
idhash: idhash 
canonical: canonical 
timestamp: timestamp 
revision: revision 
id: id 
serialized: serialized 
json: json 
following: following 
approximately: approximately 
reflect: reflect 
recent: recent 
change: changes 
learn: learn 
previous: previous 
next: next 
nycticebus: nycticebus 
linglom: linglom 
oryzomys: oryzomys 
pliocaenicus: pliocaenicus 
hack: hack 
video: video 
game: game 
series: series 
corp: corps 
united: united 
state: states 
florida: florida 
subtropical: subtropical 
storm: storm 
tropical: tropical 
depression: depression 
one: one 
hanover: hanover 
square: square 
song: songs song 
thing: thing things 
utama: utama 
vanderbilt: vanderbilt 
american: american 
show: show 
wall: walls wall 
street: street 
court: court 
world: world 
trade: trade 
london: london 
nenokkadine: nenokkadine 
airborne: airborne 
division: division 
kingdom: kingdom 
airlanding: airlanding 
brigade: brigade 
th: th 
missouri: missouri 
infantry: infantry 
regiment: regiment 
consolidated: consolidated 
armoured: armoured 
australia: australia 
army: army 
yugoslavia: yugoslavia 
group: group 
combat: combat 
team: team 
mountain: mountain 
croatian: croatian 
guard: guards 
filipino: filipino 
breakthrough: breakthrough 
artillery: artillery 
confederate: confederate 
parachute: parachute 
battalion: battalion 
split: split 
partisan: partisan 
detachment: detachment 
sustainment: sustainment 
swiss: swiss 
france: france 
west: west 
virginia: virginia 
cavalry: cavalry 
machine: machine 
gun: gun 
nd: nd 
rd: rd 
become: become 
broadway: broadway 
hour: hours 
nothing: nothing 
motorway: motorway 
road: road 
two: two 
satisfiability: satisfiability 
channel: channel 
mass: mass 
marine: marines 
canadian: canadian 
commando: commando 
law: law 
southern: southern 
ranger: ranger 
company: company 
shy: shy 
britney: britney 
spear: spears 
juno: juno 
iii: iii 
file: files 
bonnie: bonnie 
clyde: clyde 
east: east 
splash: splash 
word: words 
tetri: tetris 
volunteer: volunteer 
cheshire: cheshire 
birthday: birthday 
light: light 
battery: battery 
pioneer: pioneer 
colored: colored 
vesta: vesta 
fam: fam 
morning: morning 
intimate: intimate 
night: nights 
beyonc: beyonc 
month: months 
week: weeks 
day: days 
coventry: coventry 
ring: ring 
remix: remix 
case: case 
bmt: bmt 
fourth: fourth 
avenue: avenue 
line: line 
ninth: ninth 
station: station 
dimension: dimension 
pennsylvania: pennsylvania 
five: five 
beekman: beekman 
columbus: columbus 
circle: circle 
euro: euro 
note: note 
club: club 
theatre: theatre 
massachusetts: massachusetts 
militia: militia 
mechanised: mechanised 
soviet: soviet 
union: union 
new: new 
york: york 
piso: piso 
est: est 
fringe: fringe 
advance: advance 
river: river 
seine: seine 
palestine: palestine 
congress: congress 
communist: communist 
party: party 
worker: workers 
korea: korea 
delaware: delaware 
national: national 
vietnam: vietnam 
city: city 
subway: subway 
service: service 
independent: independent 
rhodesia: rhodesia 
khoon: khoon 
maaf: maaf 
extension: extension 
military: military 
police: police 
ix: ix 
highland: highland 
life: lives 
alexandra: alexandra 
stan: stan 
live: live 
millennium: millennium 
bc: bc 
hygiea: hygiea 
mercyme: mercyme 
album: album 
issf: issf 
meter: meter 
air: air 
pistol: pistol 
minute: minutes 
inna: inna 
story: story 
fantasy: fantasy 
bryan: bryan 
adam: adams 
retrieved: retrieved 
oldid: oldid 
wikiproject: wikiproject 
via: via 
generates: generates 
menu: menu 
