jermaine: jermaine 
jackson: jackson jacksons 
child: children child 
song: song songs 
family: family 
biography: biography 
skip: skip 
main: main 
content: content 
people: people 
nostalgia: nostalgia 
celebrity: celebrity 
history: history 
culture: culture 
crime: crime 
scandal: scandal 
video: video videos 
contact: contact 
u: us u 
advertise: advertise 
privacy: privacy 
notice: notice 
term: terms 
use: use 
copyright: copyright 
policy: policy 
ad: ad 
choice: choices 
accessibility: accessibility 
support: support 
setting: settings 
february: february 
subscribe: subscribe 
newsletter: newsletter 
photo: photo 
kevin: kevin 
winter: winter 
getty: getty 
image: images 
quick: quick 
fact: facts fact 
name: name 
birth: birth 
date: date 
november: november 
age: age 
place: place 
gary: gary 
indiana: indiana 
zodiac: zodiac 
sign: sign 
scorpio: scorpio 
related: related 
cite: cite 
page: page 
publish: publish 
may: may 
comment: comment 
member: member 
music: music 
group: group 
brother: brother brothers 
michael: michael 
fourth: fourth 
ten: ten 
initially: initially 
sang: sang 
lead: lead 
played: played 
rhythm: rhythm 
guitar: guitar 
eventually: eventually 
switched: switched 
bass: bass 
back: back 
vocal: vocals 
split: split 
went: went 
cbs: cbs 
joined: joined 
successful: successful 
tour: tour 
mended: mended 
rift: rift 
spoke: spoke 
memorial: memorial 
early: early 
life: life lives 
sibling: sibling siblings 
la: la 
jaune: jaune 
born: born 
december: december 
parent: parents 
katherine: katherine 
joseph: joseph 
musical: musical 
aspiring: aspiring 
pianist: pianist 
singer: singer 
briefly: briefly 
band: band 
falcon: falcons 
passion: passion 
pay: pay 
bill: bills 
supported: supported 
job: job 
steel: steel 
stayed: stayed 
home: home 
raised: raised 
father: father 
worked: worked 
long: long 
hour: hours 
crane: crane 
operator: operator 
tito: tito 
jackie: jackie 
practiced: practiced 
sometimes: sometimes 
one: one 
night: night 
accidentally: accidentally 
broke: broke 
string: string 
instrument: instrument 
trio: trio 
late: late 
practicing: practicing 
joe: joe 
anger: anger 
made: made 
boy: boys 
demonstrate: demonstrate 
musicianship: musicianship 
impressed: impressed 
recognized: recognized 
potential: potential 
began: began 
encouraging: encouraging 
perform: perform 
two: two 
older: older 
end: end 
younger: younger 
marlon: marlon 
also: also 
creating: creating 
talent: talent 
contest: contest 
held: held 
high: high 
school: school 
taking: taking 
performance: performances 
seriously: seriously 
moved: moved 
bassist: bassist 
several: several 
year: years year 
guitarist: guitarist 
performed: performed 
low: low 
class: class 
nightclub: nightclubs 
securing: securing 
spot: spot 
famous: famous 
amateur: amateur 
competition: competition 
apollo: apollo 
theater: theater 
harlem: harlem 
new: new 
york: york 
impressing: impressing 
motown: motown 
ceo: ceo 
berry: berry 
gordy: gordy 
awarded: awarded 
record: record records 
contract: contract 
became: became 
wildly: wildly 
first: first 
four: four 
hit: hits hit 
directly: directly 
billboard: billboard 
chart: chart charts 
solo: solo 
artist: artists artist 
still: still 
career: career 
later: later 
married: married 
daughter: daughter 
hazel: hazel 
time: time 
left: left 
loyal: loyal 
read: read 
next: next 
bella: bella 
hadid: hadid 
sadie: sadie 
alexander: alexander 
adrienne: adrienne 
kennedy: kennedy 
throughout: throughout 
fairly: fairly 
album: albums album 
let: let 
get: get 
serious: serious 
nominated: nominated 
grammy: grammy 
award: award 
daddy: daddy 
feel: feel 
fire: fire 
top: top 
hot: hot 
despite: despite 
success: success 
company: company 
arista: arista 
scored: scored 
dynamite: dynamite 
victory: victory 
since: since 
order: order 
concert: concert 
named: named 
newly: newly 
released: released 
reunion: reunion 
grossed: grossed 
million: million 
set: set 
largest: largest 
grossing: grossing 
recorded: recorded 
sporadically: sporadically 
generated: generated 
controversy: controversy 
word: word 
badd: badd 
lyric: lyrics 
changed: changed 
way: ways 
even: even 
told: told 
lie: lies 
could: could 
trust: trust 
loved: loved 
open: open 
attack: attack 
overwhelming: overwhelming 
pop: pop 
star: star 
single: single 
airwave: airwaves 
met: met 
privately: privately 
repair: repair 
brotherly: brotherly 
although: although 
pulled: pulled 
wrote: wrote 
meaning: meaning 
american: american 
dream: dream 
mini: mini 
series: series 
produced: produced 
winning: winning 
son: son 
scene: scenes 
film: film 
death: death 
abuse: abuse 
trial: trial 
favor: favor 
publicly: publicly 
defended: defended 
news: news 
show: shows 
larry: larry 
king: king 
live: live 
appeared: appeared 
court: court 
june: june 
th: th 
announce: announce 
died: died 
speaking: speaking 
medium: media 
outlet: outlets 
said: said 
wished: wished 
taken: taken 
instead: instead 
backbone: backbone 
someone: someone 
sort: sort 
like: like 
moses: moses 
thing: things 
say: say 
would: would 
funeral: funeral 
service: service 
staple: staples 
center: center 
los: los 
angeles: angeles 
served: served 
pall: pall 
bearer: bearer 
along: along 
emotional: emotional 
rendition: rendition 
smile: smile 
charlie: charlie 
chaplin: chaplin 
favorite: favorite 
breaking: breaking 
tear: tears 
wife: wives wife 
divorced: divorced 
affair: affair 
margaret: margaret 
maldonado: maldonado 
illegitimate: illegitimate 
quickly: quickly 
alejandra: alejandra 
genevieve: genevieve 
oaziaza: oaziaza 
mother: mother 
randy: randy 
filed: filed 
divorce: divorce 
three: three 
halima: halima 
rashid: rashid 
couple: couple 
currently: currently 
total: total 
eight: eight 
tv: tv 
discovery: discovery 
check: check 
strive: strive 
accuracy: accuracy 
fairness: fairness 
see: see 
something: something 
look: look 
right: right 
citation: citation 
information: information 
article: article 
title: title 
author: author 
com: com 
editor: editors 
website: website 
url: url 
access: access 
publisher: publisher 
e: e 
television: television 
network: networks 
last: last 
updated: updated 
april: april 
original: original 
published: published 
receive: receive 
story: stories 
shaped: shaped 
world: world 
person: person 
multi: multi 
talented: talented 
entertainer: entertainer 
enjoyed: enjoyed 
topping: topping 
best: best 
selling: selling 
thriller: thriller 
number: number 
bad: bad 
wall: wall 
janet: janet 
youngest: youngest 
contemporary: contemporary 
roster: roster 
includes: includes 
control: control 
nation: nation 
velvet: velvet 
rope: rope 
unbreakable: unbreakable 
musician: musician 
came: came 
fame: fame 
r: r 
b: b 
rebbie: rebbie 
eldest: eldest 
known: known 
international: international 
superstar: superstar 
rest: rest 
tj: tj 
performing: performing 
temporary: temporary 
guardianship: guardianship 
cousin: cousins 
prince: prince 
paris: paris 
blanket: blanket 
second: second 
legend: legend 
ii: ii 
bigi: bigi 
third: third 
loading: loading 
logo: logo 
registered: registered 
trademark: trademarks 
llc: llc 
close: close 
