personality: personalities personality 
celebrity: celebrity 
chef: chefs chef 
supermodel: supermodels supermodel 
biography: biography 
com: com 
skip: skip 
main: main 
content: content 
people: people 
nostalgia: nostalgia 
history: history 
culture: culture 
crime: crime 
scandal: scandal 
video: video 
contact: contact 
u: us u 
advertise: advertise 
privacy: privacy 
notice: notice 
term: terms 
use: use 
copyright: copyright 
policy: policy 
ad: ad 
choice: choices 
accessibility: accessibility 
support: support 
setting: settings 
february: february 
subscribe: subscribe 
newsletter: newsletters newsletter 
kim: kim 
kardashian: kardashian 
west: west 
gordon: gordon 
ramsay: ramsay 
kris: kris 
jenner: jenner 
prince: prince 
michael: michael 
jackson: jackson 
ii: ii 
vanna: vanna 
white: white 
paris: paris 
hilton: hilton 
simon: simon 
cowell: cowell 
talent: talents 
story: stories 
name: name 
often: often 
three: three 
generate: generate 
person: person 
bella: bella 
hadid: hadid 
american: american 
along: along 
sister: sister 
gigi: gigi 
reached: reached 
summit: summit 
fashion: fashion 
world: world 
sasha: sasha 
obama: obama 
younger: younger 
daughter: daughter 
former: former 
president: president 
barack: barack 
first: first 
lady: lady 
michelle: michelle 
malia: malia 
older: older 
jenna: jenna 
bush: bush 
hager: hager 
george: george 
w: w 
worked: worked 
teacher: teacher 
journalist: journalist 
including: including 
reporting: reporting 
today: today 
hunter: hunter 
biden: biden 
lawyer: lawyer 
investment: investment 
banker: banker 
son: son 
joe: joe 
late: late 
wife: wife 
neilia: neilia 
ashley: ashley 
jill: jill 
regis: regis 
philbin: philbin 
well: well 
known: known 
tv: tv 
co: co 
hosted: hosted 
live: live 
morning: morning 
program: program 
becoming: becoming 
host: host 
game: game games 
show: show shows 
want: wants 
millionaire: millionaire 
james: james 
holzhauer: holzhauer 
consecutive: consecutive 
jeopardy: jeopardy 
making: making 
second: second 
around: around 
champion: champion 
earnings: earnings 
totaled: totaled 
million: million 
receive: receive 
shaped: shaped 
life: lives 
sign: sign 
jojo: jojo 
siwa: siwa 
singer: singer 
dancer: dancer 
youtube: youtube 
famous: famous 
donning: donning 
big: big 
bow: bows 
hair: hair 
hit: hit 
single: singles 
boomerang: boomerang 
hold: hold 
drama: drama 
model: model 
walked: walked 
runway: runway 
biggest: biggest 
designer: designers 
industry: industry 
graced: graced 
cover: covers 
vogue: vogue 
teen: teen 
harper: harper 
bazaar: bazaar 
elle: elle 
glamour: glamour 
khlo: khlo 
reality: reality 
television: television 
starred: starred 
keeping: keeping 
kardashians: kardashians 
revenge: revenge 
body: body 
stormy: stormy 
daniel: daniels 
adult: adult 
film: film 
star: star 
whose: whose 
alleged: alleged 
affair: affair 
donald: donald 
trump: trump 
became: became 
major: major 
potential: potential 
legal: legal 
implication: implications 
attorney: attorney 
revealed: revealed 
october: october 
paid: paid 
discus: discuss 
relationship: relationship 
abby: abby 
lee: lee 
miller: miller 
tirade: tirades 
tough: tough 
training: training 
lifetime: lifetime 
dance: dance 
mom: moms 
sentenced: sentenced 
year: year 
day: day 
prison: prison 
bankruptcy: bankruptcy 
fraud: fraud 
among: among 
charge: charges 
steve: steve 
bannon: bannon 
executive: executive 
chairman: chairman 
breitbart: breitbart 
news: news 
also: also 
served: served 
ceo: ceo 
presidential: presidential 
campaign: campaign 
senior: senior 
counselor: counselor 
th: th 
ree: ree 
drummond: drummond 
blogger: blogger 
book: book 
author: author 
best: best 
pioneer: pioneer 
woman: woman 
caitlyn: caitlyn 
formerly: formerly 
bruce: bruce 
gold: gold 
medal: medal 
winning: winning 
track: track 
set: set 
record: record 
decathlon: decathlon 
summer: summer 
olympics: olympics 
amal: amal 
alamuddin: alamuddin 
clooney: clooney 
activist: activist 
distinguished: distinguished 
career: career 
focused: focused 
international: international 
law: law 
human: human 
right: rights 
issue: issues 
married: married 
actor: actor 
ayesha: ayesha 
curry: curry 
entrepreneur: entrepreneur 
hosting: hosting 
cooking: cooking 
culinary: culinary 
product: products 
nba: nba 
superstar: superstar 
stephen: stephen 
rupaul: rupaul 
drag: drag 
queen: queen 
race: race 
jr: jr 
oldest: oldest 
trustee: trustee 
organization: organization 
kellyanne: kellyanne 
conway: conway 
pollster: pollster 
political: political 
consultant: consultant 
manager: manager 
melanie: melanie 
brown: brown 
mel: mel 
b: b 
previously: previously 
scary: scary 
spice: spice 
member: member 
girl: girls girl 
british: british 
pop: pop 
group: group 
julia: julia 
child: child 
household: household 
via: via 
groundbreaking: groundbreaking 
cookbook: cookbook 
mastering: mastering 
art: art 
french: french 
popular: popular 
businesswoman: businesswoman 
creating: creating 
brand: brands 
kkw: kkw 
beauty: beauty 
fragrance: fragrance 
skim: skims 
loading: loading 
see: see 
logo: logo 
registered: registered 
trademark: trademarks 
e: e 
network: networks 
llc: llc 
close: close 
