template: template 
talk: talk 
python: python 
programming: programming 
language: language 
wikipedia: wikipedia 
free: free 
encyclopedia: encyclopedia 
jump: jump 
navigation: navigation 
search: search 
wikiproject: wikiproject 
computing: computing 
fo: foss 
rated: rated 
class: class 
within: within 
scope: scope 
collaborative: collaborative 
effort: effort 
improve: improve 
coverage: coverage 
computer: computers computer 
information: information 
technology: technology 
would: would 
like: like 
participate: participate 
please: please 
visit: visit 
project: project 
page: page 
join: join 
discussion: discussion 
see: see 
list: list 
open: open 
task: tasks 
article: articles article 
require: require 
rating: rating 
quality: quality 
scale: scale 
supported: supported 
source: source 
software: software 
science: science sciences 
related: related 
thing: things 
help: help 
awaiting: awaiting 
attention: attention 
request: requests 
requested: requested 
applied: applied 
art: arts 
internet: internet 
cleanup: cleanup 
needing: needing 
expert: expert 
copyedit: copyedit 
expand: expand 
infobox: infobox 
without: without 
infoboxes: infoboxes 
maintain: maintain 
timeline: timeline 
present: present 
photo: photo 
find: find 
picture: pictures 
biography: biographies 
scientist: scientists 
image: images 
stub: stubs 
unreferenced: unreferenced 
blps: blps 
tag: tag 
relevant: relevant 
category: categories category 
sub: sub 
removed: removed 
web: web 
framework: frameworks 
edit: edit 
bold: bold 
remove: remove 
e: e 
seem: seem 
suggest: suggest 
primarily: primarily 
php: php 
however: however 
conceived: conceived 
scripting: scripting 
still: still 
often: often 
used: used 
one: one 
also: also 
major: major 
scientific: scientific 
listing: listing 
numpy: numpy 
scipy: scipy 
sage: sage 
sympy: sympy 
quite: quite 
unfair: unfair 
qwertyus: qwertyus 
september: september 
utc: utc 
newpp: newpp 
limit: limit 
report: report 
parsed: parsed 
mw: mw 
cached: cached 
time: time 
cache: cache 
expiry: expiry 
reduced: reduced 
true: true 
complication: complications 
discussiontools: discussiontools 
usage: usage 
second: seconds 
cpu: cpu 
real: real 
preprocessor: preprocessor 
visited: visited 
node: node 
count: count 
post: post 
include: include 
size: size 
byte: bytes 
argument: argument 
highest: highest 
expansion: expansion 
depth: depth 
expensive: expensive 
parser: parser 
function: function 
unstrip: unstrip 
recursion: recursion 
lua: lua 
memory: memory 
number: number 
wikibase: wikibase 
entity: entities 
loaded: loaded 
transclusion: transclusion 
m: ms 
call: calls 
total: total 
wpbannermeta: wpbannermeta 
core: core 
hook: hooks 
taskforces: taskforces 
pagetype: pagetype 
importance: importance 
saved: saved 
key: key 
enwiki: enwiki 
pcache: pcache 
idhash: idhash 
canonical: canonical 
timestamp: timestamp 
revision: revision 
id: id 
serialized: serialized 
json: json 
retrieved: retrieved 
oldid: oldid 
na: na 
menu: menu 
