dall: dall 
e: e 
wikipedia: wikipedia 
free: free 
encyclopedia: encyclopedia 
jump: jump 
navigation: navigation 
search: search 
artificial: artificial 
intelligence: intelligence 
image: images image 
creation: creation 
program: program 
mw: mw 
parser: parser 
output: output 
infobox: infobox 
subbox: subbox 
padding: padding 
border: border 
none: none 
margin: margin 
px: px 
width: width 
auto: auto 
min: min 
font: font 
size: size 
clear: clear 
float: float 
background: background 
color: color 
transparent: transparent 
col: cols 
child: child 
navbar: navbar 
body: body 
skin: skin 
minerva: minerva 
header: header 
subheader: subheader 
title: title 
full: full 
data: data 
text: text 
align: align 
center: center 
produced: produced 
given: given 
prompt: prompts prompt 
professional: professional 
high: high 
quality: quality 
illustration: illustration illustrations 
giraffe: giraffe 
dragon: dragon 
chimera: chimera 
imitating: imitating 
made: made 
original: original 
author: author 
openai: openai 
initial: initial 
release: release 
january: january 
type: type 
transformer: transformer 
language: language languages 
model: model models 
website: website 
www: www 
com: com 
blog: blog 
sidebar: sidebar 
em: em 
right: right 
f: f 
fa: fa 
solid: solid 
aaa: aaa 
line: line 
height: height 
collapse: collapse 
display: display 
table: table 
important: important 
subgroup: subgroup 
spacing: spacing 
left: left 
outer: outer 
weight: weight 
bold: bold 
top: top 
caption: captions caption 
pretitle: pretitle 
heading: heading 
content: content contents 
bottom: bottom 
list: list lists 
c: cs c 
max: max 
mediawiki: mediawiki 
part: part 
series: series 
major: major 
goal: goals 
general: general 
planning: planning 
computer: computer 
vision: vision visions 
game: game 
playing: playing 
knowledge: knowledge 
reasoning: reasoning 
machine: machine machines 
learning: learning 
natural: natural 
processing: processing 
robotics: robotics 
approach: approaches 
symbolic: symbolic 
deep: deep 
bayesian: bayesian 
network: networks network 
evolutionary: evolutionary 
algorithm: algorithm algorithms 
philosophy: philosophy 
chinese: chinese 
room: room 
friendly: friendly 
ai: ai 
control: control 
problem: problem 
takeover: takeover 
ethic: ethics 
existential: existential 
risk: risk 
turing: turing 
test: test tests 
history: history 
timeline: timeline 
progress: progress 
winter: winter 
technology: technology 
application: applications application 
project: project projects 
programming: programming 
glossary: glossary 
inline: inline 
normal: normal 
boxtext: boxtext 
word: word 
ul: ul 
block: block 
white: white 
space: space 
nowrap: nowrap 
inherit: inherit 
bracket: brackets 
li: li 
span: span 
abbr: abbr 
decoration: decoration 
mini: mini 
variant: variant 
small: small 
cap: caps 
cursor: cursor 
ct: ct 
v: v 
stylized: stylized 
creates: creates 
textual: textual 
description: description descriptions 
revealed: revealed 
us: uses 
billion: billion 
parameter: parameters parameter 
version: version 
gpt: gpt 
interpret: interpret 
input: input inputs 
green: green 
leather: leather 
purse: purse 
shaped: shaped 
like: like 
pentagon: pentagon 
isometric: isometric 
view: view 
sad: sad 
capybara: capybara 
generate: generate 
corresponding: corresponding 
create: create 
realistic: realistic 
object: objects 
stained: stained 
glass: glass 
window: window 
blue: blue 
strawberry: strawberry 
well: well 
exist: exist 
reality: reality 
cube: cube 
texture: texture 
porcupine: porcupine 
name: name 
portmanteau: portmanteau 
wall: wall 
salvador: salvador 
dal: dal 
many: many 
neural: neural 
net: nets 
onward: onward 
able: able 
however: however 
understands: understands 
rarely: rarely 
fails: fails 
serious: serious 
way: way ways 
developed: developed 
announced: announced 
public: public 
conjunction: conjunction 
clip: clip 
contrastive: contrastive 
pre: pre 
training: training 
separate: separate 
whose: whose 
role: role 
understand: understand 
rank: rank 
generates: generates 
curated: curated 
present: presents 
highest: highest 
refused: refused 
source: source 
code: code 
either: either 
controlled: controlled 
demo: demo 
available: available 
limited: limited 
selection: selection 
sample: sample 
viewed: viewed 
open: open 
alternative: alternatives 
trained: trained 
smaller: smaller 
amount: amounts 
released: released 
community: communities 
according: according 
mit: mit 
review: review 
one: one 
objective: objectives 
give: give 
better: better 
grasp: grasp 
everyday: everyday 
concept: concepts 
human: humans human 
use: use 
make: make 
sense: sense 
thing: things 
architecture: architecture 
performance: performance 
implication: implications implication 
reference: references 
edit: edit 
hatnote: hatnote 
style: styles style 
italic: italic 
div: div 
link: link 
main: main 
article: articles article 
generative: generative 
initially: initially 
using: using 
first: first 
iteration: iteration 
scaled: scaled 
produce: produce 
multimodal: multimodal 
implementation: implementation 
swap: swaps 
pixel: pixels 
pair: pairs 
internet: internet 
zero: zero 
shot: shot 
cue: cue 
without: without 
large: large 
response: response 
another: another 
simultaneously: simultaneously 
million: million 
recognition: recognition 
system: system systems 
unlike: unlike 
classifier: classifier 
datasets: datasets 
labeled: labeled 
imagenet: imagenet 
instead: instead 
scraped: scraped 
rather: rather 
learn: learn 
single: single 
label: label 
associate: associates associate 
entire: entire 
predict: predict 
random: random 
possible: possible 
appropriate: appropriate 
allowing: allowing 
subsequently: subsequently 
identify: identify 
wide: wide 
variety: variety 
outside: outside 
set: set 
capable: capable 
generating: generating 
imagery: imagery 
photorealistic: photorealistic 
painting: paintings painting 
emoji: emoji 
also: also 
manipulate: manipulate 
rearrange: rearrange 
ability: abilities ability 
noted: noted 
creator: creators 
correct: correct 
placement: placement 
design: design 
element: element elements 
novel: novel 
composition: compositions 
explicit: explicit 
instruction: instruction 
example: example 
asked: asked 
draw: draws draw 
daikon: daikon 
radish: radish 
blowing: blowing 
nose: nose 
sipping: sipping 
latte: latte 
riding: riding 
unicycle: unicycle 
often: often 
kerchief: kerchief 
hand: hands 
foot: feet 
plausible: plausible 
location: locations 
exhibited: exhibited 
skill: skills 
coverage: coverage 
focused: focused 
subset: subset 
surreal: surreal 
quirky: quirky 
specifically: specifically 
baby: baby 
tutu: tutu 
walking: walking 
dog: dog 
mentioned: mentioned 
piece: piece pieces 
nbc: nbc 
nature: nature 
venturebeat: venturebeat 
wired: wired 
cnn: cnn 
new: new 
scientist: scientist 
bbc: bbc 
armchair: armchair 
shape: shape 
avocado: avocado 
reported: reported 
cnbc: cnbc 
contrast: contrast 
unintentional: unintentional 
development: development 
visual: visual 
sufficient: sufficient 
solve: solve 
raven: raven 
matrix: matrices 
administered: administered 
measure: measure 
engineer: engineer 
dale: dale 
markowitz: markowitz 
thenextweb: thenextweb 
introduced: introduced 
pretty: pretty 
much: much 
anything: anything 
ask: ask 
thomas: thomas 
macaulay: macaulay 
called: called 
striking: striking 
seriously: seriously 
impressive: impressive 
remarking: remarking 
entirely: entirely 
picture: pictures picture 
exploring: exploring 
structure: structure 
including: including 
fantastical: fantastical 
combining: combining 
unrelated: unrelated 
idea: ideas idea 
never: never 
fed: fed 
extremetech: extremetech 
said: said 
sometimes: sometimes 
rendering: renderings 
little: little 
fingerpainting: fingerpainting 
time: time times 
startlingly: startlingly 
accurate: accurate 
portrayal: portrayals 
techcrunch: techcrunch 
fabulously: fabulously 
interesting: interesting 
powerful: powerful 
work: work works 
occasionally: occasionally 
bizarre: bizarre 
incomprehensible: incomprehensible 
saying: saying 
may: may 
expected: expected 
suede: suede 
might: might 
nightmare: nightmare 
fuel: fuel 
hard: hard 
say: say 
black: black 
box: box 
despite: despite 
described: described 
remarkably: remarkably 
robust: robust 
change: changes change 
reliable: reliable 
producing: producing 
arbitrary: arbitrary 
sam: sam 
shead: shead 
reporting: reporting 
quoted: quoted 
neil: neil 
lawrence: lawrence 
professor: professor 
university: university 
cambridge: cambridge 
inspirational: inspirational 
demonstration: demonstration 
capacity: capacity 
store: store 
information: information 
world: world 
generalize: generalize 
find: find 
mark: mark 
riedl: riedl 
georgia: georgia 
tech: tech 
school: school 
interactive: interactive 
computing: computing 
result: results 
showed: showed 
coherently: coherently 
blend: blend 
key: key 
creativity: creativity 
remarkable: remarkable 
coherent: coherent 
seen: seen 
past: past 
year: years 
impressed: impressed 
could: could 
fill: fill 
blank: blanks 
infer: infer 
detail: details 
specific: specific 
remarked: remarked 
penguin: penguin penguins 
wearing: wearing 
christmas: christmas 
sweater: sweater sweaters 
thematically: thematically 
related: related 
santa: santa 
hat: hats 
engadget: engadget 
appropriately: appropriately 
placed: placed 
shadow: shadows 
appeared: appeared 
fox: fox 
sitting: sitting 
field: field fields 
furthermore: furthermore 
exhibit: exhibits 
broad: broad 
understanding: understanding 
trend: trends 
phone: phone 
vacuum: vacuum 
cleaner: cleaner 
specified: specified 
period: period 
changed: changed 
unusual: unusual 
telephone: telephones 
along: along 
narrow: narrow 
alphago: alphago 
alphafold: alphafold 
interest: interest 
whether: whether 
achieved: achieved 
allow: allow 
number: number 
claimed: claimed 
planned: planned 
analyze: analyze 
societal: societal 
impact: impact impacts 
potential: potential 
bias: bias 
lack: lack 
access: access 
least: least 
discussed: discussed 
several: several 
journalist: journalists 
writer: writers 
mainly: mainly 
predicting: predicting 
effect: effects 
journalism: journalism 
writing: writing 
concern: concerns 
published: published 
paper: paper 
describing: describing 
opened: opened 
sourced: sourced 
sic: sic 
write: write 
stock: stock 
photography: photography 
obituary: obituaries 
yet: yet 
vast: vast 
disrupt: disrupt 
good: good 
bad: bad 
entail: entails 
forbes: forbes 
opinion: opinion 
venture: venture 
capitalist: capitalist 
rob: rob 
toews: toews 
presaged: presaged 
dawn: dawn 
paradigm: paradigm 
known: known 
would: would 
interpreting: interpreting 
synthesizing: synthesizing 
translating: translating 
multiple: multiple 
informational: informational 
modality: modalities 
went: went 
demonstrated: demonstrated 
becoming: becoming 
harder: harder 
deny: deny 
based: based 
included: included 
clothed: clothed 
mannequin: mannequins 
item: items 
furniture: furniture 
predicted: predicted 
used: used 
fashion: fashion 
designer: designers 
going: going 
continue: continue 
improve: improve 
rapidly: rapidly 
b: b 
g: g 
h: h 
j: j 
cite: cite 
citation: citation 
wrap: wrap 
break: break 
q: q 
quote: quotes 
target: target 
rgba: rgba 
id: id 
lock: lock 
linear: linear 
gradient: gradient 
url: url 
upload: upload 
wikimedia: wikimedia 
org: org 
common: commons 
svg: svg 
repeat: repeat 
registration: registration 
gray: gray 
alt: alt 
subscription: subscription 
aa: aa 
red: red 
w: ws 
icon: icon 
wikisource: wikisource 
logo: logo 
hidden: hidden 
error: errors error 
visible: visible 
maint: maint 
format: format 
kern: kern 
selflink: selflink 
heaven: heaven 
douglas: douglas 
future: future 
retrieved: retrieved 
k: k 
johnson: johnson 
khari: khari 
debut: debuts 
archived: archived 
coldewey: coldewey 
devin: devin 
literally: literally 
grossman: grossman 
gary: gary 
engine: engine 
generator: generator 
february: february 
march: march 
andrei: andrei 
mihai: mihai 
module: module 
stunning: stunning 
zme: zme 
science: science 
walsh: walsh 
bryan: bryan 
axios: axios 
dayma: dayma 
boris: boris 
patil: patil 
suraj: suraj 
cuenca: cuenca 
pedro: pedro 
saifullah: saifullah 
khalid: khalid 
abraham: abraham 
tanishq: tanishq 
l: l 
kh: kh 
ph: ph 
melas: melas 
luke: luke 
ghosh: ghosh 
ritobrata: ritobrata 
doi: doi 
zenodo: zenodo 
radford: radford 
alec: alec 
narasimhan: narasimhan 
karthik: karthik 
salimans: salimans 
tim: tim 
sutskever: sutskever 
ilya: ilya 
june: june 
improving: improving 
pdf: pdf 
p: p 
wu: wu 
jeffrey: jeffrey 
rewon: rewon 
luan: luan 
david: david 
amodei: amodei 
dario: dario 
ilua: ilua 
unsupervised: unsupervised 
multitask: multitask 
learner: learners 
december: december 
journal: journal 
requires: requires 
help: help 
brown: brown 
tom: tom 
mann: mann 
benjamin: benjamin 
ryder: ryder 
nick: nick 
subbiah: subbiah 
melanie: melanie 
kaplan: kaplan 
jared: jared 
dhariwal: dhariwal 
prafulla: prafulla 
neelakantan: neelakantan 
arvind: arvind 
shyam: shyam 
pranav: pranav 
sastry: sastry 
girish: girish 
askell: askell 
amanda: amanda 
agarwal: agarwal 
sandhini: sandhini 
herbert: herbert 
voss: voss 
ariel: ariel 
krueger: krueger 
gretchen: gretchen 
henighan: henighan 
ramesh: ramesh 
aditya: aditya 
ziegler: ziegler 
daniel: daniel 
clemens: clemens 
hesse: hesse 
christopher: christopher 
chen: chen 
sigler: sigler 
eric: eric 
litwin: litwin 
mateusz: mateusz 
scott: scott 
chess: chess 
clark: clark 
jack: jack 
berner: berner 
mccandlish: mccandlish 
july: july 
arxiv: arxiv 
cl: cl 
pavlov: pavlov 
mikhail: mikhail 
goh: goh 
gabriel: gabriel 
chelsea: chelsea 
generation: generation 
lg: lg 
tamkin: tamkin 
alex: alex 
brundage: brundage 
mile: miles 
ganguli: ganguli 
capability: capabilities 
limitation: limitations 
dent: dent 
steve: steve 
app: app 
latest: latest 
trick: trick 
synced: synced 
dunn: dunn 
thom: thom 
transforms: transforms 
art: art 
jellyfish: jellyfish 
pikachu: pikachu 
boingboing: boingboing 
everyone: everyone 
talking: talking 
elon: elon 
musk: musk 
backed: backed 
lab: lab 
kasana: kasana 
mehreen: mehreen 
turn: turns 
suggestion: suggestion 
driven: driven 
ehrenkranz: ehrenkranz 
learned: learned 
tell: tell 
news: news 
stove: stove 
emma: emma 
tardigrade: tardigrade 
circus: circus 
tree: tree 
life: life 
best: best 
knight: knight 
go: go 
steering: steering 
self: self 
driving: driving 
car: car 
metz: metz 
rachel: rachel 
really: really 
stokel: stokel 
walker: walker 
chris: chris 
illustrator: illustrator 
imaginative: imaginative 
wakefield: wakefield 
jane: jane 
british: british 
broadcasting: broadcasting 
corporation: corporation 
magical: magical 
hello: hello 
powered: powered 
bot: bot 
weird: weird 
whitwam: whitwam 
ryan: ryan 
nichele: nichele 
stefano: stefano 
taylor: taylor 
alan: alan 
dorin: dorin 
rise: rise 
replicators: replicators 
early: early 
robot: robot robots 
reproduce: reproduce 
evolve: evolve 
genetic: genetic 
evolvable: evolvable 
cid: cid 
matter: matters 
navbox: navbox 
sizing: sizing 
inner: inner 
group: group 
abovebelow: abovebelow 
fdfdfd: fdfdfd 
tr: tr 
ccf: ccf 
ddf: ddf 
ff: ff 
even: even 
odd: odd 
hlist: hlist 
td: td 
dl: dl 
ol: ol 
differentiable: differentiable 
automatic: automatic 
differentiation: differentiation 
neuromorphic: neuromorphic 
engineering: engineering 
cable: cable 
theory: theory 
pattern: pattern 
computational: computational 
tensor: tensor 
calculus: calculus 
descent: descent 
sgd: sgd 
clustering: clustering 
regression: regression 
overfitting: overfitting 
adversary: adversary 
attention: attention 
convolution: convolution 
loss: loss 
function: function functions 
backpropagation: backpropagation 
normalization: normalization 
activation: activation 
softmax: softmax 
sigmoid: sigmoid 
rectifier: rectifier 
regularization: regularization 
augmentation: augmentation 
python: python 
julia: julia 
scientific: scientific 
hardware: hardware 
ipu: ipu 
tpu: tpu 
vpu: vpu 
memristor: memristor 
spinnaker: spinnaker 
software: software 
library: library 
tensorflow: tensorflow 
pytorch: pytorch 
kera: keras 
theano: theano 
audio: audio 
alexnet: alexnet 
wavenet: wavenet 
synthesis: synthesis 
hwr: hwr 
ocr: ocr 
speech: speech 
facial: facial 
verbal: verbal 
vec: vec 
bert: bert 
nmt: nmt 
debater: debater 
watson: watson 
decisional: decisional 
alphazero: alphazero 
sarsa: sarsa 
five: five 
muzero: muzero 
action: action 
people: people 
graf: graves 
ian: ian 
goodfellow: goodfellow 
yoshua: yoshua 
bengio: bengio 
geoffrey: geoffrey 
hinton: hinton 
yann: yann 
lecun: lecun 
andrew: andrew 
ng: ng 
demis: demis 
hassabis: hassabis 
silver: silver 
fei: fei 
organization: organizations 
deepmind: deepmind 
csail: csail 
mila: mila 
google: google 
brain: brain 
fair: fair 
portal: portals 
category: categories category 
newpp: newpp 
limit: limit 
report: report 
parsed: parsed 
cached: cached 
cache: cache 
expiry: expiry 
reduced: reduced 
false: false 
complication: complications 
vary: vary 
revision: revision 
sha: sha 
cpu: cpu 
usage: usage 
second: seconds 
real: real 
preprocessor: preprocessor 
visited: visited 
node: node 
count: count 
post: post 
expand: expand 
include: include 
byte: bytes 
template: template 
argument: argument 
expansion: expansion 
depth: depth 
expensive: expensive 
unstrip: unstrip 
recursion: recursion 
lua: lua 
memory: memory 
wikibase: wikibase 
entity: entities 
loaded: loaded 
transclusion: transclusion 
m: ms 
call: calls 
total: total 
web: web 
collapsible: collapsible 
short: short 
saved: saved 
enwiki: enwiki 
pcache: pcache 
idhash: idhash 
canonical: canonical 
timestamp: timestamp 
serialized: serialized 
json: json 
oldid: oldid 
applied: applied 
linguistics: linguistics 
modeling: modeling 
license: license 
missing: missing 
periodical: periodical 
different: different 
wikidata: wikidata 
menu: menu 
