olivia: olivia 
rodrigo: rodrigo 
sour: sour 
song: song songs 
driver: drivers driver 
liceens: liceens 
biography: biography 
skip: skip 
main: main 
content: content 
people: people 
nostalgia: nostalgia 
celebrity: celebrity 
history: history 
culture: culture 
crime: crime 
scandal: scandal 
video: video videos 
contact: contact 
u: us u 
advertise: advertise 
privacy: privacy 
notice: notice 
term: terms 
use: use 
copyright: copyright 
policy: policy 
ad: ad 
choice: choices choice 
accessibility: accessibility 
support: support 
setting: settings 
february: february 
subscribe: subscribe 
newsletter: newsletter 
photo: photo 
frazer: frazer 
harrison: harrison 
getty: getty 
image: images 
quick: quick 
fact: facts fact 
name: name 
birth: birth 
date: date 
age: age 
place: place 
murrieta: murrieta 
california: california 
zodiac: zodiac 
sign: sign 
pisces: pisces 
cite: cite 
page: page 
publish: publish 
oct: oct 
comment: comment 
american: american 
actress: actress 
singer: singers singer 
songwriter: songwriter 
found: found 
fame: fame 
tv: tv 
show: show shows 
high: high 
school: school 
musical: musical 
series: series 
releasing: releasing 
hit: hits hit 
single: singles single 
license: license 
grew: grew 
demonstrated: demonstrated 
early: early 
ability: abilities ability 
music: music 
included: included 
composing: composing 
child: child 
landed: landed 
starring: starring 
role: roles role 
bizaardvark: bizaardvark 
released: released 
heartrending: heartrending 
debut: debut 
january: january 
billboard: billboard 
hot: hot 
first: first 
one: one 
billion: billion 
stream: streams 
followed: followed 
acclaimed: acclaimed 
album: albums album 
life: life lives 
interest: interest 
isabel: isabel 
born: born 
xa: xa 
temecula: temecula 
parent: parents 
jennifer: jennifer 
teacher: teacher 
chris: chris 
family: family 
marriage: marriage 
therapist: therapist 
mother: mother 
introduced: introduced 
alternative: alternative 
rock: rock 
doubt: doubt 
white: white 
stripe: stripes 
smashing: smashing 
pumpkin: pumpkins 
showed: showed 
affinity: affinity 
started: started 
singing: singing 
lesson: lessons 
soon: soon 
competing: competing 
local: local 
contest: contests 
talent: talent 
also: also 
writing: writing 
young: young 
began: began 
piano: piano 
initially: initially 
hated: hated 
studying: studying 
came: came 
appreciate: appreciate 
instrument: instrument 
helped: helped 
songwriting: songwriting 
youthful: youthful 
composition: compositions 
often: often 
focused: focused 
heartbreak: heartbreak 
even: even 
boyfriend: boyfriend 
literally: literally 
wrote: wrote 
breakup: breakup 
ever: ever 
held: held 
boy: boy 
hand: hand 
told: told 
acting: acting 
audition: audition auditions 
disney: disney 
stardom: stardom 
time: time times 
taking: taking 
class: classes 
production: productions 
professional: professional 
job: jobs 
would: would 
take: take 
mile: mile 
trek: trek 
los: los 
angeles: angeles 
overnight: overnight 
success: successes success 
pushed: pushed 
become: become 
daughter: daughter 
could: could 
stop: stop 
auditioning: auditioning 
however: however 
determined: determined 
continue: continue 
got: got 
lead: lead 
girl: girls girl 
grace: grace 
stir: stirs 
year: year 
old: old 
cast: cast 
paige: paige 
olvera: olvera 
starred: starred 
alongside: alongside 
madison: madison 
hu: hu 
remains: remains 
close: close 
friend: friend friends 
required: required 
learn: learn 
guitar: guitar 
meant: meant 
getting: getting 
leaving: leaving 
public: public 
behind: behind 
nini: nini 
salazar: salazar 
robert: roberts 
addition: addition 
continued: continued 
write: write 
shared: shared 
instagram: instagram 
led: led 
asking: asking 
compose: compose 
hsm: hsm 
tm: tm 
t: ts 
character: character 
performed: performed 
resulting: resulting 
ballad: ballad 
want: want 
became: became 
charted: charted 
read: read 
next: next 
bella: bella 
hadid: hadid 
sadie: sadie 
alexander: alexander 
adrienne: adrienne 
kennedy: kennedy 
drew: drew 
attention: attention 
multiple: multiple 
label: labels 
ultimately: ultimately 
signed: signed 
geffen: geffen 
record: record records 
start: starts 
programming: programming 
miley: miley 
cyrus: cyrus 
selena: selena 
gomez: gomez 
hollywood: hollywood 
marked: marked 
different: different 
trajectory: trajectory 
admitted: admitted 
think: think 
specific: specific 
archetype: archetype 
star: star 
turned: turned 
pop: pop 
follow: follow 
producer: producer 
dan: dan 
nigro: nigro 
reached: reached 
seeing: seeing 
sing: sing 
recorded: recorded 
release: release 
debuted: debuted 
making: making 
youngest: youngest 
performer: performer 
accomplish: accomplish 
radio: radio 
spotify: spotify 
apple: apple 
youtube: youtube 
amazon: amazon 
tiktok: tiktok 
countless: countless 
lip: lip 
synched: synched 
created: created 
cover: cover 
confessional: confessional 
style: style styles 
compared: compared 
taylor: taylor 
swift: swift 
idol: idol 
sparked: sparked 
rumor: rumors 
costar: costar 
joshua: joshua 
bassett: bassett 
appeal: appeal 
go: goes 
beyond: beyond 
fan: fans 
new: new 
york: york 
cool: cool 
thing: thing 
seen: seen 
many: many 
like: like 
idea: idea 
really: really 
love: love 
tune: tune 
reach: reach 
reflected: reflected 
viral: viral 
saturday: saturday 
night: night 
live: live 
sketch: sketch 
group: group 
men: men 
rhapsodized: rhapsodized 
performance: performances performance 
opted: opted 
create: create 
full: full 
length: length 
instead: instead 
sticking: sticking 
prior: prior 
plan: plan 
ep: ep 
worked: worked 
hour: hours 
day: day days 
seven: seven 
week: week 
complete: complete 
produced: produced 
co: co 
every: every 
april: april 
deja: deja 
vu: vu 
went: went 
made: made 
two: two 
launch: launch 
top: top 
another: another 
good: good 
arrived: arrived 
may: may 
chart: chart 
topper: topper 
wonder: wonder 
critical: critical 
commercial: commercial 
proud: proud 
heartfelt: heartfelt 
address: address 
writes: writes 
authenticity: authenticity 
truth: truth 
declared: declared 
truthfully: truthfully 
happiness: happiness 
everything: everything 
feeling: feeling feelings 
point: point 
putting: putting 
something: something 
feel: feel 
important: important 
say: say 
track: tracks 
reflect: reflect 
variety: variety 
influence: influences 
include: include 
fiona: fiona 
alanis: alanis 
morissette: morissette 
green: green 
tonight: tonight 
jimmy: jimmy 
fallon: fallon 
due: due 
covid: covid 
pandemic: pandemic 
happen: happen 
brit: brit 
award: award awards 
united: united 
kingdom: kingdom 
bonus: bonus 
meet: meet 
episode: episode 
month: months month 
personal: personal 
experience: experiences 
german: german 
irish: irish 
heritage: heritage 
father: father 
filipino: filipino 
descent: descent 
biracial: biracial 
confessed: confessed 
always: always 
way: way 
ethnic: ethnic 
world: world 
thought: thought 
better: better 
happier: happier 
hope: hopes 
speak: speak 
similar: similar 
insecurity: insecurities 
experienced: experienced 
breakthrough: breakthrough 
graduated: graduated 
moved: moved 
apartment: apartment 
july: july 
visited: visited 
house: house 
met: met 
president: president 
joe: joe 
biden: biden 
part: part 
effort: effort 
encourage: encourage 
get: get 
vaccine: vaccine 
aware: aware 
impact: impact 
fashion: fashion 
planet: planet 
opts: opts 
eco: eco 
conscious: conscious 
well: well 
thrifting: thrifting 
vintage: vintage 
exchanging: exchanging 
clothes: clothes 
check: check 
strive: strive 
accuracy: accuracy 
fairness: fairness 
see: see 
look: look 
right: right 
citation: citation 
information: information 
article: article 
title: title 
author: author 
com: com 
editor: editors 
website: website 
url: url 
access: access 
publisher: publisher 
e: e 
television: television 
network: networks 
last: last 
updated: updated 
october: october 
original: original 
published: published 
receive: receive 
story: stories 
shaped: shaped 
person: person 
newton: newton 
john: john 
known: known 
playing: playing 
sandy: sandy 
film: film 
grease: grease 
battled: battled 
breast: breast 
cancer: cancer 
raise: raise 
awareness: awareness 
colman: colman 
british: british 
number: number 
profile: profile 
queen: queen 
elizabeth: elizabeth 
ii: ii 
season: seasons 
three: three 
four: four 
netflix: netflix 
crown: crown 
de: de 
havilland: havilland 
best: best 
melanie: melanie 
gone: gone 
wind: wind 
academy: academy 
heiress: heiress 
munn: munn 
hosting: hosting 
duty: duties 
attack: attack 
newsroom: newsroom 
x: x 
apocalypse: apocalypse 
rihanna: rihanna 
international: international 
popstar: popstar 
umbrella: umbrella 
so: sos 
diamond: diamonds 
work: work 
patty: patty 
hearst: hearst 
granddaughter: granddaughter 
th: th 
century: century 
medium: media 
mogul: mogul 
william: william 
randolph: randolph 
kidnapped: kidnapped 
symbionese: symbionese 
liberation: liberation 
army: army 
spent: spent 
captor: captors 
joining: joining 
criminal: criminal 
act: acts 
kidnapping: kidnapping 
captured: captured 
fbi: fbi 
ansel: ansel 
adam: adams 
photographer: photographer 
iconic: iconic 
west: west 
including: including 
yosemite: yosemite 
national: national 
park: park 
kurt: kurt 
cobain: cobain 
talented: talented 
yet: yet 
troubled: troubled 
grunge: grunge 
frontman: frontman 
nirvana: nirvana 
legend: legend 
nevermind: nevermind 
utero: utero 
grammy: grammy 
winner: winner 
founding: founding 
member: members 
black: black 
eyed: eyed 
pea: peas 
solo: solo 
artist: artist 
activist: activist 
loading: loading 
logo: logo 
registered: registered 
trademark: trademarks 
llc: llc 
