antonin: antonin 
scalia: scalia 
dissent: dissents dissent 
child: children child 
supreme: supreme 
court: court courts 
biography: biography 
skip: skip 
main: main 
content: content 
people: people 
nostalgia: nostalgia 
celebrity: celebrity 
history: history 
culture: culture 
crime: crime 
scandal: scandal 
video: video 
contact: contact 
u: us u 
advertise: advertise 
privacy: privacy 
notice: notice 
term: terms 
use: use 
copyright: copyright 
policy: policy 
ad: ad 
choice: choices 
accessibility: accessibility 
support: support 
setting: settings 
february: february 
subscribe: subscribe 
newsletter: newsletter 
quick: quick 
fact: facts fact 
name: name 
birth: birth 
date: date 
march: march 
death: death 
education: education 
harvard: harvard 
law: law 
school: school 
georgetown: georgetown 
university: university 
place: place 
trenton: trenton 
new: new 
jersey: jersey 
shafter: shafter 
texas: texas 
nickname: nickname 
nino: nino 
full: full 
gregory: gregory 
cite: cite 
page: page 
publish: publish 
sep: sep 
comment: comment 
best: best 
known: known 
associate: associate 
justice: justices justice 
appointed: appointed 
president: president 
ronald: ronald 
reagan: reagan 
lawyer: lawyer 
practicing: practicing 
worked: worked 
public: public 
service: service 
role: roles role 
xa: xa 
richard: richard 
nixon: nixon 
general: general 
counsel: counsel 
assistant: assistant 
attorney: attorney 
became: became 
part: part 
appeal: appeals 
nominated: nominated 
serving: serving 
capacity: capacity 
background: background 
family: family 
life: life lives 
born: born 
salvadore: salvadore 
eugene: eugene 
catherine: catherine 
panaro: panaro 
father: father 
emigrated: emigrated 
sicily: sicily 
teenager: teenager 
came: came 
elli: ellis 
island: island 
got: got 
college: college 
professor: professor 
romance: romance 
language: languages 
brooklyn: brooklyn 
mother: mother 
first: first 
generation: generation 
italian: italian 
american: americans american 
elementary: elementary 
teacher: teacher 
early: early 
acquired: acquired 
partly: partly 
remembrance: remembrance 
grandfather: grandfather 
named: named 
young: young 
boy: boy 
enjoyed: enjoyed 
immediate: immediate 
well: well 
extended: extended 
rare: rare 
occurrence: occurrence 
catholic: catholic 
clan: clans 
time: time 
admitted: admitted 
center: center 
much: much 
attention: attention 
gave: gave 
secure: secure 
feeling: feeling 
growing: growing 
also: also 
meant: meant 
everyone: everyone 
expectation: expectations 
put: put 
squarely: squarely 
major: major 
influence: influence 
providing: providing 
core: core 
value: values 
conservatism: conservatism 
hard: hard 
work: work 
discipline: discipline 
exhibited: exhibited 
adult: adult 
grew: grew 
multi: multi 
ethnic: ethnic 
neighborhood: neighborhood 
queen: queens 
york: york 
city: city 
attended: attended 
straight: straight 
student: student 
went: went 
xavier: xavier 
high: high 
manhattan: manhattan 
military: military 
run: run 
jesuit: jesuit 
order: order 
church: church 
deep: deep 
religious: religious 
conviction: conviction 
developed: developed 
self: self 
described: described 
cool: cool 
kid: kid 
spent: spent 
absorbed: absorbed 
continued: continued 
receive: receive 
academic: academic 
mark: marks 
finished: finished 
class: class 
enrolled: enrolled 
washington: washington 
c: c 
graduated: graduated 
valedictorian: valedictorian 
summa: summa 
cum: cum 
laude: laude 
bachelor: bachelors 
degree: degree 
graduation: graduation 
study: study 
final: final 
year: year 
met: met 
maureen: maureen 
mccarthy: mccarthy 
undergraduate: undergraduate 
radcliffe: radcliffe 
couple: couple 
married: married 
september: september 
nine: nine 
together: together 
legal: legal 
career: career 
began: began 
office: offices office 
jones: jones 
day: day 
cockley: cockley 
reavis: reavis 
cleveland: cleveland 
ohio: ohio 
highly: highly 
regarded: regarded 
would: would 
likely: likely 
made: made 
partner: partner 
like: like 
longed: longed 
teach: teach 
took: took 
professorial: professorial 
position: position 
virginia: virginia 
moved: moved 
charlottesville: charlottesville 
entered: entered 
telecommunication: telecommunications 
helped: helped 
formulate: formulate 
regulation: regulations 
cable: cable 
television: television 
industry: industry 
aftermath: aftermath 
watergate: watergate 
council: council 
testified: testified 
congressional: congressional 
committee: committees 
behalf: behalf 
gerald: gerald 
ford: ford 
administration: administration 
executive: executive 
privilege: privilege 
later: later 
argued: argued 
case: cases case 
alfred: alfred 
dunhill: dunhill 
london: london 
inc: inc 
v: v 
republic: republic 
cuba: cuba 
government: government 
brief: brief 
stint: stint 
conservative: conservatives conservative 
enterprise: enterprise 
institute: institute 
teaching: teaching 
post: post 
chicago: chicago 
accepted: accepted 
appointment: appointment 
district: district 
columbia: columbia 
built: built 
record: record 
praise: praise 
circle: circles 
powerful: powerful 
witty: witty 
writing: writing 
often: often 
critical: critical 
bound: bound 
follow: follow 
lower: lower 
judge: judges judge 
drew: drew 
official: officials 
short: short 
list: list 
nomination: nomination 
confirmed: confirmed 
upon: upon 
retirement: retirement 
chief: chief 
warren: warren 
burger: burger 
read: read 
next: next 
bella: bella 
hadid: hadid 
sadie: sadie 
alexander: alexander 
adrienne: adrienne 
kennedy: kennedy 
considered: considered 
one: one 
prominent: prominent 
thinker: thinkers 
blunt: blunt 
say: say 
scathing: scathing 
earned: earned 
reputation: reputation 
combative: combative 
insulting: insulting 
yet: yet 
many: many 
knew: knew 
personally: personally 
unpretentious: unpretentious 
charming: charming 
funny: funny 
closest: closest 
friend: friends 
ruth: ruth 
bader: bader 
ginsburg: ginsburg 
whose: whose 
political: political 
view: view views 
vastly: vastly 
different: different 
photo: photo 
wikimedia: wikimedia 
common: common commons 
adhered: adhered 
judicial: judicial 
philosophy: philosophy 
originalism: originalism 
hold: holds 
constitution: constitution 
interpreted: interpreted 
theoretically: theoretically 
ratified: ratified 
two: two 
century: century centuries 
ago: ago 
direct: direct 
conflict: conflict 
commonly: commonly 
held: held 
living: living 
document: document 
allowing: allowing 
take: take takes 
account: account 
contemporary: contemporary 
society: society 
supposed: supposed 
facilitate: facilitate 
change: change 
impede: impede 
citizen: citizens 
basic: basic 
fundamental: fundamental 
right: right rights 
responsibility: responsibilities 
abhorred: abhorred 
activism: activism 
believed: believed 
implementing: implementing 
legislature: legislature 
represented: represented 
critic: critics 
interpretation: interpretation 
impediment: impediment 
toward: toward 
progress: progress 
point: point 
example: examples 
founder: founders 
repugnant: repugnant 
today: today 
standard: standards 
racial: racial 
gender: gender 
equality: equality 
opponent: opponents 
stress: stress 
interpreting: interpreting 
original: original 
form: form 
progressive: progressive 
declared: declared 
unconstitutional: unconstitutional 
adhere: adhere 
intent: intent 
reason: reasons 
oftentimes: oftentimes 
accused: accused 
personal: personal 
judgment: judgment 
course: course 
characterized: characterized 
anchor: anchor 
majority: majority 
quarter: quarter 
especially: especially 
socially: socially 
politically: politically 
group: groups 
puzzled: puzzled 
pleased: pleased 
liberal: liberals 
voting: voting 
uphold: uphold 
free: free 
speech: speech 
flag: flag 
burning: burning 
striking: striking 
prohibition: prohibition 
hate: hate 
keeping: keeping 
strove: strove 
limit: limit 
abortion: abortion 
rejecting: rejecting 
notion: notion 
religiously: religiously 
motivated: motivated 
stressing: stressing 
issue: issue 
decided: decided 
apology: apology 
accusation: accusation 
bush: bush 
gore: gore 
handed: handed 
election: election 
george: george 
w: w 
telling: telling 
thing: thing 
confounded: confounded 
observer: observers 
recusal: recusal 
withdrew: withdrew 
topic: topics 
interest: interest 
pledge: pledge 
allegiance: allegiance 
elk: elk 
grove: grove 
newdow: newdow 
refused: refused 
recuse: recuse 
cheney: cheney 
dc: dc 
even: even 
though: though 
close: close 
relationship: relationship 
vice: vice 
dick: dick 
affordable: affordable 
care: care 
act: act 
june: june 
decision: decision 
king: king 
burwell: burwell 
upholding: upholding 
key: key 
component: component 
obamacare: obamacare 
headline: headlines 
voicing: voicing 
called: called 
allowed: allowed 
federal: federal 
provide: provide 
nationwide: nationwide 
tax: tax 
subsidy: subsidies 
help: help 
buy: buy 
health: health 
insurance: insurance 
x: x 
interpretive: interpretive 
jiggery: jiggery 
pokery: pokery 
word: words 
longer: longer 
meaning: meaning 
dissenting: dissenting 
opinion: opinion 
wrote: wrote 
start: start 
calling: calling 
scotuscare: scotuscare 
referring: referring 
acronym: acronym 
used: used 
refer: refer 
united: united 
state: states 
scotus: scotus 
added: added 
reflects: reflects 
endure: endure 
whatever: whatever 
distortion: distortions 
correct: correct 
flaw: flaw 
statutory: statutory 
machinery: machinery 
ignores: ignores 
give: give 
congress: congress 
legislative: legislative 
power: powers 
enumerated: enumerated 
ruling: ruling 
highest: highest 
announced: announced 
landmark: landmark 
guaranteeing: guaranteeing 
sex: sex 
marriage: marriage 
voted: voted 
along: along 
fellow: fellow 
john: john 
robert: roberts 
clarence: clarence 
thomas: thomas 
samuel: samuel 
alito: alito 
expressed: expressed 
decide: decide 
odds: odds 
principle: principles 
nation: nation 
old: old 
found: found 
dead: dead 
luxury: luxury 
resort: resort 
west: west 
reportedly: reportedly 
died: died 
natural: natural 
cause: causes 
report: reports 
revealing: revealing 
suffered: suffered 
heart: heart 
trouble: trouble 
blood: blood 
pressure: pressure 
check: check 
strive: strive 
accuracy: accuracy 
fairness: fairness 
see: see 
something: something 
look: look 
citation: citation 
information: information 
article: article 
title: title 
author: author 
com: com 
editor: editors 
website: website 
url: url 
access: access 
publisher: publisher 
e: e 
network: networks 
last: last 
updated: updated 
published: published 
april: april 
story: stories 
shaped: shaped 
world: world 
sign: sign 
person: person 
anthony: anthony 
served: served 
stephen: stephen 
breyer: breyer 
bill: bill 
clinton: clinton 
lengthy: lengthy 
elena: elena 
kagan: kagan 
woman: woman 
serve: serve 
solicitor: solicitor 
america: america 
second: second 
sonia: sonia 
sotomayor: sotomayor 
barack: barack 
obama: obama 
may: may 
latina: latina 
oliver: oliver 
wendell: wendell 
holmes: holmes 
jr: jr 
civil: civil 
war: war 
veteran: veteran 
expert: expert 
janet: janet 
reno: reno 
broke: broke 
ground: ground 
loading: loading 
logo: logo 
registered: registered 
trademark: trademarks 
llc: llc 
