amy: amy 
klobuchar: klobuchar 
age: age 
husband: husband 
education: education 
biography: biography 
skip: skip 
main: main 
content: content 
people: people 
nostalgia: nostalgia 
celebrity: celebrity 
history: history 
culture: culture 
crime: crime 
scandal: scandal 
video: video 
contact: contact 
u: us u 
advertise: advertise 
privacy: privacy 
notice: notice 
term: term terms 
use: use 
copyright: copyright 
policy: policies policy 
ad: ad 
choice: choices choice 
accessibility: accessibility 
support: support 
setting: settings 
february: february 
subscribe: subscribe 
newsletter: newsletter 
photo: photo 
ethan: ethan 
miller: miller 
getty: getty 
image: images 
quick: quick 
fact: facts fact 
name: name 
birth: birth 
date: date 
may: may 
place: place places 
plymouth: plymouth 
minnesota: minnesota 
zodiac: zodiac 
sign: sign 
gemini: gemini 
cite: cite 
page: page 
publish: publish 
nov: nov 
comment: comment 
lawyer: lawyer 
senator: senator 
among: among 
candidate: candidates candidate 
democratic: democratic 
presidential: presidential 
nomination: nomination 
known: known 
pragmatism: pragmatism 
successfully: successfully 
reaching: reaching 
across: across 
aisle: aisle 
started: started 
corporate: corporate 
elected: elected 
senate: senate 
seat: seat 
multiple: multiple 
time: times time 
since: since 
first: first 
election: election 
announced: announced 
candidacy: candidacy 
race: race 
exiting: exiting 
field: field 
march: march 
early: early 
life: life lives 
jean: jean 
born: born 
mother: mothers mother 
elementary: elementary 
school: school 
teacher: teacher teachers 
father: father 
sportswriter: sportswriter 
star: star 
tribune: tribune 
younger: younger 
sister: sister 
parent: parents 
divorced: divorced 
publicly: publicly 
shared: shared 
past: past 
contentious: contentious 
relationship: relationship 
due: due 
alcoholism: alcoholism 
later: later 
made: made 
amends: amends 
stopped: stopped 
drinking: drinking 
excelling: excelling 
academic: academics 
valedictorian: valedictorian 
high: high 
went: went 
study: study 
political: political 
science: science 
yale: yale 
graduating: graduating 
receiving: receiving 
b: b 
accepted: accepted 
university: university 
chicago: chicago 
law: law 
graduated: graduated 
career: career 
work: work works 
county: county 
prosecutor: prosecutor 
became: became 
partner: partner 
two: two 
different: different 
firm: firms 
minneapolis: minneapolis 
area: areas area 
interest: interest 
politics: politics 
came: came 
gave: gave 
daughter: daughter 
discovered: discovered 
swallowing: swallowing 
issue: issues 
despite: despite 
condition: condition 
hospital: hospital 
demanded: demanded 
leave: leave 
hour: hour hours 
window: window 
admission: admission 
expired: expired 
ired: ired 
experience: experience 
lobbied: lobbied 
state: state states 
legislature: legislature 
demanding: demanding 
stay: stay 
extended: extended 
new: new 
newborn: newborns 
successful: successful 
turning: turning 
advocacy: advocacy 
president: president 
bill: bill 
clinton: clinton 
signed: signed 
federal: federal 
judge: judge 
kavanaugh: kavanaugh 
hearing: hearings 
controversial: controversial 
scotus: scotus 
brett: brett 
pushed: pushed 
national: national 
spotlight: spotlight 
member: member 
judiciary: judiciary 
committee: committee 
seen: seen 
cool: cool 
headed: headed 
fair: fair 
minded: minded 
questioned: questioned 
nominee: nominee 
explained: explained 
living: living 
alcoholic: alcoholic 
proceeded: proceeded 
ask: ask 
ever: ever 
blacked: blacked 
excessive: excessive 
offended: offended 
irate: irate 
threw: threw 
question: question 
back: back 
apologized: apologized 
reactionary: reactionary 
response: response 
towards: towards 
x: x 
c: c 
lot: lot 
thing: things 
try: try 
go: go 
viral: viral 
reason: reason 
think: think 
going: going 
get: get 
much: much 
attention: attention 
xa: xa 
told: told 
vogue: vogue 
admittedly: admittedly 
taken: taken 
aback: aback 
belligerent: belligerent 
said: said 
teased: teased 
staff: staff 
asking: asking 
guy: guys 
anticipate: anticipate 
added: added 
reaction: reaction 
also: also 
kind: kind 
sad: sad 
campaign: campaign 
run: run 
employing: employing 
sense: sense 
humor: humor 
one: one 
journalist: journalist 
described: described 
mom: mom 
joke: jokes 
regularly: regularly 
trail: trail 
bet: bet 
aside: aside 
realistic: realistic 
middle: middle 
road: road 
approach: approach 
would: would 
attract: attract 
voter: voters 
battleground: battleground 
serving: serving 
third: third 
tried: tried 
message: message 
could: could 
blue: blue 
red: red 
atlantic: atlantic 
someone: someone 
proved: proved 
win: win 
premise: premise 
entire: entire 
american: americans american 
need: need 
appeal: appeal 
like: like 
michigan: michigan 
wisconsin: wisconsin 
pennsylvania: pennsylvania 
swung: swung 
toward: toward 
trump: trump 
democrat: democrat democrats 
proven: proven 
ability: ability 
read: read 
next: next 
bella: bella 
hadid: hadid 
sadie: sadie 
alexander: alexander 
adrienne: adrienne 
kennedy: kennedy 
endured: endured 
crowded: crowded 
narrowed: narrowed 
single: single 
digit: digits 
save: save 
surprise: surprise 
finish: finish 
hampshire: hampshire 
primary: primary 
consistently: consistently 
trailed: trailed 
fellow: fellow 
moderate: moderates 
joe: joe 
biden: biden 
pete: pete 
buttigieg: buttigieg 
ran: ran 
away: away 
convincing: convincing 
south: south 
carolina: carolina 
ending: ending 
endorsing: endorsing 
former: former 
vice: vice 
healthcare: healthcare 
vocal: vocal 
critic: critic 
bernie: bernie 
sander: sanders 
elizabeth: elizabeth 
warren: warren 
medicare: medicare 
plan: plans plan 
believed: believed 
adding: adding 
onto: onto 
existing: existing 
affordable: affordable 
care: care 
act: act 
providing: providing 
public: public 
option: option 
referred: referred 
aspiration: aspiration 
calling: calling 
bad: bad 
idea: idea 
force: force 
private: private 
insurance: insurance 
additionally: additionally 
sponsored: sponsored 
bipartisan: bipartisan 
designed: designed 
lower: lower 
prescription: prescription 
drug: drug 
cost: costs 
well: well 
requirement: requirement 
eligible: eligible 
climate: climate 
day: days 
office: office 
reenter: reenter 
paris: paris 
agreement: agreement 
negotiate: negotiate 
even: even 
stronger: stronger 
emission: emissions 
standard: standards 
bring: bring 
clean: clean 
power: power 
fuel: fuel 
economy: economy 
proponent: proponent 
green: green 
deal: deal 
wanted: wanted 
set: set 
america: america 
path: path 
net: net 
zero: zero 
year: year 
odds: odds 
progressive: progressives 
completely: completely 
eliminating: eliminating 
college: college 
debt: debt 
instead: instead 
called: called 
refinancing: refinancing 
student: student 
loan: loan 
help: help 
reduce: reduce 
tuition: tuition 
free: free 
technical: technical 
training: training 
community: community 
supported: supported 
increasing: increasing 
pay: pay 
immigration: immigration 
advocated: advocated 
reforming: reforming 
ice: ice 
abolishing: abolishing 
offering: offering 
undocumented: undocumented 
immigrant: immigrants 
without: without 
criminal: criminal 
record: records 
pathway: pathway 
citizenship: citizenship 
abortion: abortion 
staunch: staunch 
pro: pro 
supporter: supporter 
personal: personal 
married: married 
minnesotan: minnesotan 
john: john 
bessler: bessler 
professor: professor 
baltimore: baltimore 
teach: teaches 
georgetown: georgetown 
center: center 
adjunct: adjunct 
together: together 
couple: couple 
abigail: abigail 
graduate: graduate 
alma: alma 
mater: mater 
york: york 
city: city 
council: council 
stand: stand 
comedy: comedy 
side: side 
religion: religion 
attends: attends 
united: united 
church: church 
christ: christ 
mainline: mainline 
protestant: protestant 
value: value 
interfaith: interfaith 
relation: relations 
upholds: upholds 
liberal: liberal 
view: views 
sexual: sexual 
orientation: orientation 
civil: civil 
right: right rights 
woman: women 
check: check 
strive: strive 
accuracy: accuracy 
fairness: fairness 
see: see 
something: something 
look: look 
citation: citation 
information: information 
article: article 
title: title 
author: author 
eudie: eudie 
pak: pak 
website: website 
com: com 
url: url 
access: access 
publisher: publisher 
e: e 
television: television 
network: networks 
last: last 
updated: updated 
august: august 
original: original 
published: published 
november: november 
receive: receive 
story: stories 
shaped: shaped 
world: world 
person: person 
massachusetts: massachusetts 
party: party 
mayor: mayor 
bend: bend 
indiana: indiana 
current: current 
secretary: secretary 
transportation: transportation 
openly: openly 
gay: gay 
man: man 
cabinet: cabinet 
juli: juli 
n: n 
castro: castro 
san: san 
antonio: antonio 
texas: texas 
hud: hud 
obama: obama 
administration: administration 
andrew: andrew 
yang: yang 
businessman: businessman 
book: book 
philanthropist: philanthropist 
marco: marco 
rubio: rubio 
representing: representing 
florida: florida 
unsuccessful: unsuccessful 
bid: bid 
republican: republican 
beto: beto 
rourke: rourke 
congressman: congressman 
represented: represented 
th: th 
district: district 
house: house 
representative: representatives 
kirsten: kirsten 
gillibrand: gillibrand 
politician: politician 
served: served 
jack: jack 
kevorkian: kevorkian 
based: based 
physician: physician 
assisted: assisted 
patient: patient 
suicide: suicides 
sparking: sparking 
increased: increased 
talk: talk 
hospice: hospice 
die: die 
legislative: legislative 
action: action 
tulsi: tulsi 
gabbard: gabbard 
congresswoman: congresswoman 
represents: represents 
hawaii: hawaii 
iraq: iraq 
war: war 
veteran: veteran 
major: major 
army: army 
guard: guard 
loading: loading 
logo: logo 
registered: registered 
trademark: trademarks 
llc: llc 
close: close 
