usher: usher 
age: age 
song: song songs 
fact: facts fact 
biography: biography 
skip: skip 
main: main 
content: content 
people: people 
nostalgia: nostalgia 
celebrity: celebrity 
history: history 
culture: culture 
crime: crime 
scandal: scandal 
video: video videos 
contact: contact 
u: us u 
advertise: advertise 
privacy: privacy 
notice: notice 
term: terms 
use: use 
copyright: copyright 
policy: policy 
ad: ad 
choice: choices choice 
accessibility: accessibility 
support: support 
setting: settings 
february: february 
subscribe: subscribe 
newsletter: newsletter 
photo: photo 
christie: christie 
goodwin: goodwin 
redferns: redferns 
via: via 
getty: getty 
image: images 
quick: quick 
name: name 
birth: birth 
date: date 
october: october 
place: place 
chattanooga: chattanooga 
tennessee: tennessee 
aka: aka 
terry: terry 
raymond: raymond 
full: full 
iv: iv 
zodiac: zodiac 
sign: sign 
libra: libra 
early: early 
year: years year 
album: albums album 
film: film 
tv: tv 
role: roles role 
project: projects 
personal: personal 
life: life lives 
cite: cite 
page: page 
quote: quotes 
sleeping: sleeping 
forbidden: forbidden 
work: work works 
play: play 
time: time 
game: game 
publish: publish 
apr: apr 
comment: comment 
successful: successful 
american: american 
r: r 
b: b 
pop: pop 
musician: musician 
began: began 
making: making 
music: music 
hit: hits hit 
include: include 
way: way 
confession: confessions 
looking: looking 
entered: entered 
fame: fame 
two: two 
moved: moved 
mother: mother 
brother: brother 
atlanta: atlanta 
performing: performing 
star: star 
search: search 
landed: landed 
recording: recording 
contract: contract 
laface: laface 
record: record records 
released: released 
first: first 
dominated: dominated 
airwave: airwaves 
releasing: releasing 
sold: sold 
million: million 
copy: copies 
week: week 
june: june 
produced: produced 
found: found 
spot: spot 
billboard: billboard 
chart: chart charts 
repeatedly: repeatedly 
earning: earning 
several: several 
grammy: grammy 
award: award awards 
among: among 
honor: honors 
born: born 
xa: xa 
dallas: dallas 
texas: texas 
raised: raised 
singing: singing 
church: church 
choir: choir 
six: six 
old: old 
moving: moving 
performed: performed 
show: show shows 
soon: soon 
self: self 
titled: titled 
became: became 
known: known 
polished: polished 
vocal: vocal vocals 
broad: broad 
range: range 
chic: chic 
style: style 
sexy: sexy 
dance: dance 
move: moves 
sensual: sensual 
ballad: ballads 
dominant: dominant 
player: player 
industry: industry 
across: across 
different: different 
musical: musical 
genre: genres 
including: including 
blue: blues 
following: following 
second: second 
single: singles 
nice: nice 
slow: slow 
make: make 
wanna: wanna 
skyrocketed: skyrocketed 
young: young 
artist: artist 
selling: selling 
quickly: quickly 
lauded: lauded 
fluid: fluid 
addictive: addictive 
melody: melodies 
also: also 
incorporating: incorporating 
sexual: sexual 
undertone: undertones 
performance: performances performance 
live: live 
followed: followed 
incredibly: incredibly 
included: included 
got: got 
bad: bad 
well: well 
winning: winning 
remind: remind 
call: call 
united: united 
state: states 
alone: alone 
nearly: nearly 
decade: decades decade 
extremely: extremely 
received: received 
sale: sales 
accumulated: accumulated 
worldwide: worldwide 
burn: burn 
part: part 
ii: ii 
yeah: yeah 
collaboration: collaboration 
ludacris: ludacris 
lil: lil 
jon: jon 
impressive: impressive 
track: track 
achieved: achieved 
top: top 
seven: seven 
named: named 
later: later 
three: three 
best: best 
contemporary: contemporary 
duo: duo 
group: groups group 
rap: rap 
sung: sung 
release: release 
v: v 
grammys: grammys 
male: male 
go: goes 
baby: baby 
singer: singer 
eight: eight 
soul: soul 
train: train 
five: five 
nine: nine 
society: society 
composer: composers 
author: author authors 
publisher: publisher publishers 
march: march 
announced: announced 
working: working 
eighth: eighth 
studio: studio 
entitled: entitled 
ur: ur 
described: described 
would: would 
urban: urban 
previous: previous 
already: already 
good: good 
kisser: kisser 
came: came 
give: give 
featuring: featuring 
nicki: nicki 
minaj: minaj 
mind: mind 
juicy: juicy 
j: j 
outside: outside 
worked: worked 
stage: stage 
actor: actor 
one: one 
earliest: earliest 
teen: teen 
horror: horror 
faculty: faculty 
went: went 
guest: guest 
appearance: appearances 
television: television 
marvin: marvin 
gaye: gaye 
program: programs program 
dream: dreams 
played: played 
disc: disc 
jockey: jockey 
mix: mix 
lead: lead 
billy: billy 
flynn: flynn 
broadway: broadway 
chicago: chicago 
read: read 
next: next 
bella: bella 
hadid: hadid 
sadie: sadie 
alexander: alexander 
adrienne: adrienne 
kennedy: kennedy 
newest: newest 
judge: judges judge 
coach: coaches 
voice: voice 
popular: popular 
competition: competition 
series: series 
nbc: nbc 
along: along 
latin: latin 
songstress: songstress 
shakira: shakira 
made: made 
debut: debut 
season: season 
premiere: premiere 
replacing: replacing 
cee: cee 
lo: lo 
green: green 
christina: christina 
aguilera: aguilera 
starred: starred 
alongside: alongside 
returning: returning 
adam: adam 
levine: levine 
blake: blake 
shelton: shelton 
viewer: viewers 
offbeat: offbeat 
coaching: coaching 
despite: despite 
success: success 
sit: sit 
fifth: fifth 
return: return 
chair: chairs 
sixth: sixth 
stay: stays 
busy: busy 
charity: charity 
new: new 
look: look 
foundation: foundation 
founded: founded 
provide: provide 
funding: funding 
child: children child 
foster: foster 
care: care 
service: service 
hold: holds 
conference: conferences 
camp: camps 
risk: risk 
youth: youth 
ultimately: ultimately 
promote: promote 
leadership: leadership 
skill: skills 
kid: kids 
impoverished: impoverished 
community: communities 
nonprofit: nonprofit 
boy: boy boys 
girl: girls 
club: clubs 
america: america 
trumpet: trumpet 
national: national 
association: association 
advancement: advancement 
colored: colored 
additionally: additionally 
invested: invested 
entrepreneurial: entrepreneurial 
endeavor: endeavors 
owns: owns 
label: label 
men: men 
cologne: cologne 
line: line 
co: co 
owner: owner 
cleveland: cleveland 
cavalier: cavaliers 
basketball: basketball 
team: team 
dated: dated 
chili: chili 
former: former 
member: member 
female: female 
tlc: tlc 
married: married 
tameka: tameka 
together: together 
naviyd: naviyd 
ely: ely 
couple: couple 
divorced: divorced 
july: july 
son: son 
relationship: relationship 
stepson: stepson 
kyle: kyle 
glover: glover 
suffered: suffered 
severe: severe 
brain: brain 
injury: injury injuries 
water: water 
accident: accident 
according: according 
medium: media 
report: reports 
riding: riding 
inflatable: inflatable 
tube: tube 
lake: lake 
lanier: lanier 
georgia: georgia 
jet: jet 
ski: ski 
struck: struck 
head: head 
knocked: knocked 
unconscious: unconscious 
rushed: rushed 
local: local 
hospital: hospital 
declared: declared 
dead: dead 
doctor: doctors 
tragedy: tragedy 
family: family 
august: august 
caught: caught 
pool: pool 
drain: drain 
home: home 
aunt: aunt 
watching: watching 
incident: incident 
happened: happened 
tried: tried 
free: free 
taken: taken 
nearby: nearby 
survived: survived 
ex: ex 
wife: wife 
launched: launched 
legal: legal 
battle: battle 
regain: regain 
custody: custody 
claim: claims 
capable: capable 
providing: providing 
daily: daily 
caregiving: caregiving 
supervision: supervision 
minor: minor 
filing: filing 
cnn: cnn 
case: case 
disagreed: disagreed 
allowed: allowed 
retain: retain 
september: september 
longtime: longtime 
girlfriend: girlfriend 
manager: manager 
grace: grace 
miguel: miguel 
executive: executive 
def: def 
jam: jam 
separation: separation 
marriage: marriage 
jenn: jenn 
goicoechea: goicoechea 
welcomed: welcomed 
daughter: daughter 
sovereign: sovereign 
bo: bo 
may: may 
pair: pair 
expecting: expecting 
check: check 
strive: strive 
accuracy: accuracy 
fairness: fairness 
see: see 
something: something 
right: right 
citation: citation 
information: information 
article: article 
title: title 
com: com 
editor: editors 
website: website 
url: url 
access: access 
e: e 
network: networks 
last: last 
updated: updated 
original: original 
published: published 
april: april 
receive: receive 
story: story stories 
shaped: shaped 
world: world 
person: person 
toni: toni 
braxton: braxton 
songwriter: songwriter 
actress: actress 
un: un 
break: break 
heart: heart 
mean: mean 
breathe: breathe 
gwen: gwen 
stefani: stefani 
enjoyed: enjoyed 
founding: founding 
ska: ska 
doubt: doubt 
solo: solo 
lady: ladies lady 
gaga: gaga 
icon: icon 
poker: poker 
face: face 
golden: golden 
globe: globe 
oscar: oscar 
nomination: nomination 
starring: starring 
cyndi: cyndi 
lauper: lauper 
rose: rose 
string: string 
want: want 
fun: fun 
jennifer: jennifer 
lopez: lopez 
hollywood: hollywood 
leading: leading 
forged: forged 
career: career 
ray: ray 
charles: charles 
pioneer: pioneer 
integrating: integrating 
gospel: gospel 
country: country 
create: create 
like: like 
unchain: unchain 
road: road 
jack: jack 
dolly: dolly 
parton: parton 
cultural: cultural 
whose: whose 
powerful: powerful 
songwriting: songwriting 
established: established 
presence: presence 
stevie: stevie 
wonder: wonder 
prodigy: prodigy 
creative: creative 
figure: figures 
th: th 
century: century 
cherie: cherie 
amour: amour 
sunshine: sunshine 
superstition: superstition 
britney: britney 
spear: spears 
sometimes: sometimes 
controversial: controversial 
act: acts 
reached: reached 
loading: loading 
logo: logo 
registered: registered 
trademark: trademarks 
llc: llc 
close: close 
