nelson: nelson 
mandela: mandela 
quote: quotes 
spouse: spouse 
death: death 
biography: biography 
skip: skip 
main: main 
content: content 
people: people 
nostalgia: nostalgia 
celebrity: celebrity 
history: history 
culture: culture 
crime: crime 
scandal: scandal 
video: video 
contact: contact 
u: us u 
advertise: advertise 
privacy: privacy 
notice: notice 
term: terms 
use: use 
copyright: copyright 
policy: policies policy 
ad: ad 
choice: choices choice 
accessibility: accessibility 
support: support 
setting: settings 
february: february 
subscribe: subscribe 
newsletter: newsletter 
photo: photos photo 
per: per 
anders: anders 
pettersson: pettersson 
getty: getty 
image: images 
quick: quick 
fact: facts fact 
name: name 
birth: birth 
date: date 
july: july 
december: december 
know: know 
african: africans african 
rolihlahla: rolihlahla 
mean: means 
troublemaker: troublemaker 
became: became 
first: first 
black: black 
president: president 
south: south 
africa: africa 
serving: serving 
beginning: beginning 
spent: spent 
year: years year 
prison: prison 
political: political 
offense: offenses 
education: education 
wesleyan: wesleyan 
college: college 
university: university 
london: london 
clarkebury: clarkebury 
boarding: boarding 
institute: institute 
fort: fort 
hare: hare 
witwatersrand: witwatersrand 
johannesburg: johannesburg 
place: place 
mvezo: mvezo 
transkei: transkei 
cite: cite 
page: page 
hate: hate 
race: race 
discrimination: discrimination 
intensely: intensely 
manifestation: manifestations 
fought: fought 
life: life lives 
fight: fight 
end: end 
day: days day 
difficulty: difficulties 
break: break 
men: men 
make: make 
others: others 
axe: axe 
sharp: sharp 
enough: enough 
cut: cut 
soul: soul 
sinner: sinner 
keep: keeps keep 
trying: trying 
one: one 
armed: armed 
hope: hope 
rise: rise 
even: even 
something: something 
inevitable: inevitable 
man: man 
done: done 
considers: considers 
duty: duty 
country: country 
rest: rest 
peace: peace 
believe: believe 
made: made 
effort: effort efforts 
therefore: therefore 
sleep: sleep 
eternity: eternity 
conduct: conduct 
morality: morality 
integrity: integrity 
consistency: consistency 
need: needs need 
fear: fear 
force: forces 
inhumanity: inhumanity 
cruelty: cruelty 
everyone: everyone 
circumstance: circumstances 
achieve: achieve 
success: success 
dedicated: dedicated 
passionate: passionate 
march: march 
freedom: freedom 
irreversible: irreversible 
must: must 
allow: allow 
stand: stand 
way: way 
denied: denied 
right: right rights 
live: live 
belief: believes 
become: become 
outlaw: outlaw 
learned: learned 
courage: courage 
absence: absence 
triumph: triumph 
brave: brave 
feel: feel 
afraid: afraid 
conquers: conquers 
tremendous: tremendous 
patience: patience 
perseverance: perseverance 
test: test 
commitment: commitment 
moment: moment 
come: come 
responsibility: responsibilities 
dare: dare 
linger: linger 
long: long 
walk: walk 
yet: yet 
ended: ended 
lifetime: lifetime 
struggle: struggles struggle 
white: white 
domination: domination 
cherished: cherished 
ideal: ideal 
democratic: democratic 
free: free 
society: society 
person: person persons 
together: together 
harmony: harmony 
equal: equal 
opportunity: opportunities opportunity 
prepared: prepared 
die: die 
merely: merely 
cast: cast 
chain: chains 
respect: respects 
enhances: enhances 
want: want 
enemy: enemy 
work: work 
becomes: becomes 
partner: partner 
goodness: goodness 
flame: flame 
hidden: hidden 
never: never 
extinguished: extinguished 
law: law 
criminal: criminal 
stood: stood 
thought: thought thoughts 
conscience: conscience 
greatest: greatest 
glory: glory 
living: living 
lie: lies 
falling: falling 
rising: rising 
every: every 
time: time times 
fall: fall 
wherever: wherever 
world: world 
let: let 
reaffirm: reaffirm 
vision: vision 
none: none 
exploited: exploited 
oppressed: oppressed 
dispossessed: dispossessed 
another: another 
publish: publish 
apr: apr 
comment: comment 
elected: elected 
anti: anti 
apartheid: apartheid 
nobel: nobel 
prize: prize 
social: social 
activist: activist activists 
politician: politician 
philanthropist: philanthropist 
becoming: becoming 
involved: involved 
movement: movement 
joined: joined 
national: national 
congress: congress 
directed: directed 
campaign: campaign 
peaceful: peaceful 
nonviolent: nonviolent 
defiance: defiance 
government: government 
racist: racist 
xa: xa 
f: f 
w: w 
de: de 
klerk: klerk 
jointly: jointly 
awarded: awarded 
dismantle: dismantle 
system: system 
generation: generations 
source: source 
inspiration: inspiration 
civil: civil 
worldwide: worldwide 
early: early 
born: born 
tiny: tiny 
village: village 
bank: bank banks 
mbashe: mbashe 
river: river 
xhosa: xhosa 
language: language 
literally: literally 
pulling: pulling 
branch: branches branch 
tree: tree 
commonly: commonly 
translates: translates 
father: father 
destined: destined 
chief: chiefs chief 
served: served 
counselor: counselor 
tribal: tribal 
several: several 
lost: lost 
title: title 
fortune: fortune 
dispute: dispute 
local: local 
colonial: colonial 
magistrate: magistrate 
infant: infant 
loss: loss 
status: status 
forced: forced 
mother: mother 
move: move 
family: family 
qunu: qunu 
smaller: smaller 
north: north 
nestled: nestled 
narrow: narrow 
grassy: grassy 
valley: valley 
road: road roads 
footpath: footpaths 
linked: linked 
pasture: pastures 
livestock: livestock 
grazed: grazed 
lived: lived 
hut: huts 
ate: ate 
harvest: harvest 
maize: maize 
sorghum: sorghum 
pumpkin: pumpkin 
bean: beans 
could: could 
afford: afford 
water: water 
came: came 
spring: springs 
stream: streams 
cooking: cooking 
outdoors: outdoors 
played: played 
game: games 
young: young 
boy: boy boys 
acting: acting 
male: male 
passage: passage 
scenario: scenarios 
toy: toys 
natural: natural 
material: materials 
available: available 
including: including 
clay: clay 
suggestion: suggestion 
friend: friend friends 
baptized: baptized 
methodist: methodist 
church: church 
went: went 
attend: attend 
school: school schools 
custom: customs custom 
probably: probably 
due: due 
bias: bias 
british: british 
educational: educational 
teacher: teacher 
told: told 
new: new 
would: would 
old: old 
died: died 
lung: lung 
disease: disease 
causing: causing 
change: change 
dramatically: dramatically 
adopted: adopted 
jongintaba: jongintaba 
dalindyebo: dalindyebo 
regent: regent 
thembu: thembu 
gesture: gesture 
favor: favor 
earlier: earlier 
recommended: recommended 
subsequently: subsequently 
left: left 
carefree: carefree 
knew: knew 
fearing: fearing 
see: see 
traveled: traveled 
motorcar: motorcar 
mqhekezweni: mqhekezweni 
provincial: provincial 
capital: capital 
thembuland: thembuland 
royal: royal 
residence: residence 
though: though 
forgotten: forgotten 
beloved: beloved 
quickly: quickly 
adapted: adapted 
sophisticated: sophisticated 
surroundings: surroundings 
given: given 
two: two 
child: children child 
son: son 
oldest: oldest 
justice: justice 
daughter: daughter daughters 
nomafu: nomafu 
took: took 
class: classes 
room: room 
next: next 
palace: palace 
studying: studying 
english: english 
geography: geography 
period: period 
developed: developed 
interest: interest 
elder: elders elder 
great: great 
official: official 
business: business 
relative: relative 
coming: coming 
according: according 
previously: previously 
brother: brothers 
shattered: shattered 
fellowship: fellowship 
shared: shared 
land: land 
air: air 
thing: things 
inspiring: inspiring 
gallery: gallery 
read: reads read 
awakening: awakening 
partake: partake 
traditional: traditional 
circumcision: circumcision 
ritual: rituals ritual 
mark: mark 
entrance: entrance 
manhood: manhood 
ceremony: ceremony 
surgical: surgical 
procedure: procedure 
elaborate: elaborate 
preparation: preparation 
tradition: tradition 
uncircumcised: uncircumcised 
cannot: cannot 
inherit: inherit 
wealth: wealth 
marry: marry 
officiate: officiate 
participated: participated 
welcomed: welcomed 
felt: felt 
ready: ready 
transition: transition 
boyhood: boyhood 
mood: mood 
shifted: shifted 
proceeding: proceedings 
however: however 
meligqili: meligqili 
speaker: speaker 
spoke: spoke 
sadly: sadly 
explaining: explaining 
enslaved: enslaved 
controlled: controlled 
power: powers power 
govern: govern 
said: said 
lament: lament 
promise: promise 
squandered: squandered 
struggled: struggled 
perform: perform 
mindless: mindless 
chore: chores 
later: later 
say: say 
word: words 
total: total 
sense: sense 
eventually: eventually 
formulate: formulate 
resolve: resolve 
independent: independent 
download: download 
card: card 
guardianship: guardianship 
groomed: groomed 
assume: assume 
high: high 
office: office 
royalty: royalty 
attended: attended 
mission: mission 
state: state states 
achieved: achieved 
academic: academic 
plain: plain 
hard: hard 
also: also 
excelled: excelled 
track: track 
boxing: boxing 
initially: initially 
mocked: mocked 
classmate: classmates 
student: student students 
mathona: mathona 
female: female 
enrolled: enrolled 
residential: residential 
center: center 
higher: higher 
learning: learning 
considered: considered 
equivalent: equivalent 
harvard: harvard 
drawing: drawing 
scholar: scholars 
part: part parts 
sub: sub 
saharan: saharan 
required: required 
course: courses 
focused: focused 
roman: roman 
dutch: dutch 
prepare: prepare 
career: career 
service: service 
interpreter: interpreter 
clerk: clerk 
regarded: regarded 
best: best 
profession: profession 
obtain: obtain 
second: second 
representative: representative 
council: council 
dissatisfied: dissatisfied 
food: food 
lack: lack 
held: held 
src: src 
election: elections election 
majority: majority 
voted: voted 
boycott: boycott 
unless: unless 
demand: demands 
met: met 
aligning: aligning 
resigned: resigned 
position: position 
seeing: seeing 
act: act acts 
insubordination: insubordination 
expelled: expelled 
gave: gave 
ultimatum: ultimatum 
return: return 
agreed: agreed 
serve: serve 
returned: returned 
home: home 
furious: furious 
telling: telling 
unequivocally: unequivocally 
recant: recant 
decision: decision 
go: go 
back: back 
week: weeks 
announced: announced 
arranged: arranged 
marriage: marriage 
wanted: wanted 
sure: sure 
properly: properly 
planned: planned 
arrangement: arrangement 
within: within 
dictated: dictated 
shocked: shocked 
news: news 
feeling: feeling 
trapped: trapped 
believing: believing 
option: option 
follow: follow 
recent: recent 
order: order 
ran: ran 
away: away 
settled: settled 
worked: worked 
variety: variety 
job: jobs 
guard: guard 
completing: completing 
bachelor: bachelor 
degree: degree 
via: via 
correspondence: correspondence 
study: study 
soon: soon 
actively: actively 
joining: joining 
anc: anc 
small: small 
group: groups group 
banded: banded 
calling: calling 
youth: youth 
league: league 
goal: goal goals 
transform: transform 
mass: mass 
grassroots: grassroots 
deriving: deriving 
strength: strength 
million: millions 
rural: rural 
peasant: peasants 
working: working 
voice: voice 
current: current 
regime: regime 
specifically: specifically 
believed: believed 
tactic: tactics 
polite: polite 
petitioning: petitioning 
ineffective: ineffective 
officially: officially 
method: methods method 
strike: strike 
disobedience: disobedience 
non: non 
cooperation: cooperation 
full: full 
citizenship: citizenship 
redistribution: redistribution 
trade: trade 
union: union 
compulsory: compulsory 
founded: founded 
firm: firm 
tambo: tambo 
partnering: partnering 
oliver: oliver 
brilliant: brilliant 
attending: attending 
provided: provided 
low: low 
cost: cost 
legal: legal 
counsel: counsel 
unrepresented: unrepresented 
arrested: arrested 
charged: charged 
treason: treason 
advocacy: advocacy 
acquitted: acquitted 
meanwhile: meanwhile 
challenged: challenged 
africanists: africanists 
breed: breed 
pacifist: pacifist 
broke: broke 
form: form 
pan: pan 
africanist: africanist 
negatively: negatively 
affected: affected 
much: much 
militant: militant 
leader: leaders leader 
wife: wife 
married: married 
three: three 
six: six 
wed: wed 
evelyn: evelyn 
ntoko: ntoko 
mase: mase 
couple: couple 
four: four 
madiba: madiba 
thembekile: thembekile 
makgatho: makgatho 
makaziwe: makaziwe 
nine: nine 
month: months 
maki: maki 
divorced: divorced 
winnie: winnie 
madikizela: madikizela 
zenani: zenani 
argentina: argentina 
ambassador: ambassador 
zindziswa: zindziswa 
denmark: denmark 
separating: separating 
bella: bella 
hadid: hadid 
sadie: sadie 
alexander: alexander 
adrienne: adrienne 
kennedy: kennedy 
graca: graca 
machel: machel 
minister: minister 
mozambique: mozambique 
remained: remained 
formerly: formerly 
committed: committed 
protest: protest 
began: began 
co: co 
umkhonto: umkhonto 
sizwe: sizwe 
known: known 
mk: mk 
offshoot: offshoot 
sabotage: sabotage 
guerilla: guerilla 
war: war 
orchestrated: orchestrated 
worker: workers 
leading: leading 
following: following 
sentenced: sentenced 
five: five 
brought: brought 
trial: trial 
imprisonment: imprisonment 
november: november 
incarcerated: incarcerated 
robben: robben 
island: island 
contracted: contracted 
tuberculosis: tuberculosis 
prisoner: prisoner 
received: received 
lowest: lowest 
level: level 
treatment: treatment 
able: able 
earn: earn 
program: program 
memoir: memoir 
intelligence: intelligence 
agent: agent 
gordon: gordon 
winter: winter 
described: described 
plot: plot 
arrange: arrange 
escape: escape 
shoot: shoot 
recapture: recapture 
foiled: foiled 
continued: continued 
potent: potent 
symbol: symbol 
resistance: resistance 
coordinated: coordinated 
international: international 
release: release 
launched: launched 
groundswell: groundswell 
exemplified: exemplified 
esteem: esteem 
global: global 
community: community 
moved: moved 
pollsmoor: pollsmoor 
allegedly: allegedly 
enable: enable 
p: p 
botha: botha 
offered: offered 
exchange: exchange 
renouncing: renouncing 
flatly: flatly 
rejected: rejected 
offer: offer 
increasing: increasing 
pressure: pressure 
talk: talks 
ensuing: ensuing 
deal: deal 
suffered: suffered 
stroke: stroke 
replaced: replaced 
frederik: frederik 
willem: willem 
finally: finally 
lifted: lifted 
ban: ban 
removed: removed 
restriction: restrictions 
suspended: suspended 
execution: executions 
upon: upon 
immediately: immediately 
urged: urged 
foreign: foreign 
reduce: reduce 
constitutional: constitutional 
reform: reform 
stated: stated 
toward: toward 
declared: declared 
continue: continue 
vote: vote 
lifelong: lifelong 
colleague: colleague 
chairperson: chairperson 
dismantling: dismantling 
negotiated: negotiated 
multiracial: multiracial 
willing: willing 
share: share 
many: many 
complete: complete 
transfer: transfer 
negotiation: negotiations 
often: often 
strained: strained 
violent: violent 
eruption: eruptions 
assassination: assassination 
chris: chris 
hani: hani 
throughout: throughout 
delicate: delicate 
balance: balance 
intense: intense 
amid: amid 
demonstration: demonstrations 
presidency: presidency 
prevailed: prevailed 
april: april 
inaugurated: inaugurated 
may: may 
age: age 
deputy: deputy 
june: june 
bring: bring 
minority: minorities minority 
rule: rule 
used: used 
nation: nation 
enthusiasm: enthusiasm 
sport: sports 
pivot: pivot 
point: point 
promote: promote 
reconciliation: reconciliation 
encouraging: encouraging 
hated: hated 
rugby: rugby 
team: team 
stage: stage 
hosting: hosting 
cup: cup 
recognition: recognition 
prestige: prestige 
republic: republic 
merit: merit 
protect: protect 
economy: economy 
collapse: collapse 
reconstruction: reconstruction 
development: development 
plan: plan 
funded: funded 
creation: creation 
housing: housing 
basic: basic 
health: health 
care: care 
signed: signed 
constitution: constitution 
establishing: establishing 
strong: strong 
central: central 
based: based 
guaranteeing: guaranteeing 
expression: expression 
retirement: retirement 
general: general 
retired: retired 
active: active 
politics: politics 
maintain: maintain 
busy: busy 
schedule: schedule 
raising: raising 
money: money 
build: build 
clinic: clinics 
heartland: heartland 
foundation: foundation 
mediator: mediator 
burundi: burundi 
diagnosed: diagnosed 
treated: treated 
prostate: prostate 
cancer: cancer 
formal: formal 
public: public 
native: native 
aiming: aiming 
publicly: publicly 
privately: privately 
find: find 
solution: solutions 
toughest: toughest 
issue: issues 
included: included 
desmond: desmond 
tutu: tutu 
kofi: kofi 
annan: annan 
ela: ela 
bhatt: bhatt 
gro: gro 
harlem: harlem 
brundtland: brundtland 
jimmy: jimmy 
carter: carter 
li: li 
zhaoxing: zhaoxing 
mary: mary 
robinson: robinson 
muhammad: muhammad 
yunus: yunus 
impact: impact 
spanned: spanned 
asia: asia 
middle: middle 
east: east 
action: actions 
promoting: promoting 
woman: women 
equality: equality 
demanding: demanding 
atrocity: atrocities 
supporting: supporting 
initiative: initiatives 
address: address 
humanitarian: humanitarian 
crisis: crises 
democracy: democracy 
addition: addition 
advocating: advocating 
scale: scale 
aid: aids 
relationship: relationship 
barack: barack 
obama: obama 
last: last 
appearance: appearance 
final: final 
match: match 
largely: largely 
spotlight: spotlight 
choosing: choosing 
spend: spend 
childhood: childhood 
visit: visit 
lady: lady 
michelle: michelle 
trip: trip 
junior: junior 
senator: senator 
illinois: illinois 
united: united 
suffering: suffering 
infection: infection 
january: january 
briefly: briefly 
hospitalized: hospitalized 
undergo: undergo 
surgery: surgery 
stomach: stomach 
ailment: ailment 
released: released 
returning: returning 
testing: testing 
medical: medical 
relating: relating 
recurrent: recurrent 
hospital: hospital 
canceled: canceled 
scheduled: scheduled 
remain: remain 
husband: husband 
side: side 
dlamini: dlamini 
flew: flew 
jacob: jacob 
zuma: zuma 
issued: issued 
statement: statement 
response: response 
concern: concern 
scare: scare 
asking: asking 
prayer: prayer 
appeal: appeal 
pray: pray 
speaking: speaking 
legacy: legacy 
movie: movie 
book: books book 
published: published 
autobiography: autobiography 
secretly: secretly 
written: written 
inspired: inspired 
number: number 
among: among 
easy: easy 
favorite: favorite 
folktale: folktales 
birthday: birthday 
celebrate: celebrate 
annual: annual 
event: event 
meant: meant 
encourage: encourage 
citizen: citizens 
give: gives give 
website: website 
mr: mr 
fighting: fighting 
humanity: humanity 
minute: minutes 
whether: whether 
chosen: chosen 
charity: charity 
check: check 
strive: strive 
accuracy: accuracy 
fairness: fairness 
look: look 
citation: citation 
information: information 
article: article 
author: author 
com: com 
editor: editors 
url: url 
access: access 
publisher: publisher 
e: e 
television: television 
network: networks 
updated: updated 
original: original 
receive: receive 
story: stories 
shaped: shaped 
sign: sign 
controversial: controversial 
varying: varying 
governmental: governmental 
role: roles 
steve: steve 
biko: biko 
spearheaded: spearheaded 
consciousness: consciousness 
award: award 
winner: winner 
renowned: renowned 
anglican: anglican 
cleric: cleric 
staunch: staunch 
opposition: opposition 
party: party 
primarily: primarily 
exile: exile 
rockefeller: rockefeller 
john: john 
jr: jr 
governor: governor 
york: york 
appointed: appointed 
vice: vice 
gerald: gerald 
ford: ford 
baby: baby 
face: face 
robber: robber 
killer: killer 
associate: associate 
dillinger: dillinger 
willie: willie 
singer: singer 
songwriter: songwriter 
hit: hit 
song: songs 
like: like 
crazy: crazy 
judd: judd 
actor: actor 
playing: playing 
bad: bad 
guy: guys 
antihero: antiheroes 
portrayal: portrayal 
tough: tough 
teenager: teenager 
breakfast: breakfast 
club: club 
helped: helped 
star: star 
tracy: tracy 
actress: actress 
ricky: ricky 
kristin: kristin 
harmon: harmon 
loading: loading 
logo: logo 
registered: registered 
trademark: trademarks 
llc: llc 
close: close 
