james: james 
patterson: patterson 
book: books book 
life: life lives 
fact: facts fact 
biography: biography 
skip: skip 
main: main 
content: content 
people: people 
nostalgia: nostalgia 
celebrity: celebrity 
history: history 
culture: culture 
crime: crime 
scandal: scandal 
video: video 
contact: contact 
u: us u 
advertise: advertise 
privacy: privacy 
notice: notice 
term: terms 
use: use 
copyright: copyright 
policy: policy 
ad: ad 
choice: choices 
accessibility: accessibility 
support: support 
setting: settings 
february: february 
subscribe: subscribe 
newsletter: newsletter 
quick: quick 
name: name 
birth: birth 
date: date 
march: march 
age: age 
place: place 
newburgh: newburgh 
new: new 
york: york 
full: full 
zodiac: zodiac 
sign: sign 
aries: aries 
early: early 
year: years year 
cite: cite 
page: page 
publish: publish 
mar: mar 
comment: comment 
prolific: prolific 
author: author authors 
thriller: thriller thrillers 
mystery: mysteries mystery 
young: young 
adult: adult 
novel: novels novel 
first: first 
successful: successful 
series: series 
featured: featured 
psychologist: psychologist 
alex: alex 
cross: cross 
written: written 
detective: detective 
story: story stories 
science: science 
fiction: fiction 
romance: romance 
xa: xa 
published: published 
continued: continued 
moving: moving 
rank: ranks 
advertising: advertising 
world: world 
decided: decided 
leave: leave 
executive: executive 
focus: focus 
writing: writing 
time: time times 
hold: holds 
guinness: guinness 
record: record records 
best: best 
seller: sellers seller 
list: list 
born: born 
good: good 
student: student 
enjoy: enjoy 
reading: reading 
graduated: graduated 
high: high 
school: school 
attended: attended 
manhattan: manhattan 
college: college 
undergraduate: undergraduate 
starting: starting 
coursework: coursework 
master: master 
degree: degree 
english: english 
literature: literature 
vanderbilt: vanderbilt 
university: university 
left: left 
took: took 
job: job 
copywriter: copywriter 
agency: agency 
j: j 
walter: walter 
thompson: thompson 
success: success 
though: though 
climbed: climbed 
company: company 
eventually: eventually 
becoming: becoming 
north: north 
american: american 
ceo: ceo 
also: also 
wrote: wrote 
spare: spare 
thomas: thomas 
berryman: berryman 
number: number 
came: came 
edgar: edgar 
award: award 
top: top 
prize: prize 
writer: writers writer 
penned: penned 
several: several 
achieved: achieved 
breakout: breakout 
along: along 
spider: spider 
used: used 
work: work works 
experience: experience 
orchestrate: orchestrate 
television: television 
campaign: campaign 
helped: helped 
become: become 
order: order 
many: many 
protagonist: protagonist 
include: include 
kiss: kiss 
girl: girls 
pop: pop 
go: go goes 
weasel: weasel 
violet: violets 
blue: blue 
mary: mary 
heart: heart 
morgan: morgan 
freeman: freeman 
tyler: tyler 
perry: perry 
portrayed: portrayed 
movie: movie 
adaptation: adaptations 
varied: varied 
genre: genres genre 
city: city 
michael: michael 
bennett: bennett 
adopted: adopted 
child: children 
another: another 
popular: popular 
woman: women 
murder: murder 
club: club 
adapted: adapted 
short: short 
lived: lived 
tv: tv 
show: show shows 
repertoire: repertoire 
extends: extends 
historical: historical 
even: even 
nonfiction: nonfiction 
addition: addition 
authored: authored 
younger: younger 
reader: readers 
maximum: maximum 
ride: ride 
witch: witch 
wizard: wizard 
whatever: whatever 
known: known 
involving: involving 
turning: turning 
read: read 
next: next 
bella: bella 
hadid: hadid 
sadie: sadie 
alexander: alexander 
adrienne: adrienne 
kennedy: kennedy 
process: process 
appears: appears 
released: released 
output: output 
help: help 
co: co 
miracle: miracle 
th: th 
green: green 
peter: peter 
de: de 
jonge: jonge 
later: later 
teamed: teamed 
former: former 
president: president 
bill: bill 
clinton: clinton 
pen: pen 
missing: missing 
working: working 
writes: writes 
extensive: extensive 
outline: outline 
sent: sent 
produce: produces 
draft: draft 
keeping: keeping 
eye: eye 
progression: progression 
handling: handling 
revision: revisions 
earned: earned 
sell: sell 
million: millions million 
e: e 
ever: ever 
growing: growing 
already: already 
accumulated: accumulated 
according: according 
may: may 
article: article 
january: january 
sold: sold 
worldwide: worldwide 
earns: earns 
brand: brand 
management: management 
became: became 
case: case 
study: study 
harvard: harvard 
business: business 
personal: personal 
honor: honors 
married: married 
sue: sue 
solie: solie 
two: two 
son: son 
jack: jack 
following: following 
belief: belief 
importance: importance 
helping: helping 
learn: learn 
love: love 
compelled: compelled 
set: set 
readkiddoread: readkiddoread 
com: com 
website: website 
advises: advises 
parent: parents 
selecting: selecting 
awarded: awarded 
national: national 
foundation: foundation 
literarian: literarian 
outstanding: outstanding 
service: service 
literary: literary 
community: community 
donated: donated 
public: public 
library: libraries 
independent: independent 
bookstore: bookstores 
throughout: throughout 
donald: donald 
trump: trump 
humanity: humanities 
medal: medal 
check: check 
strive: strive 
accuracy: accuracy 
fairness: fairness 
see: see 
something: something 
look: look 
right: right rights 
citation: citation 
information: information 
title: title 
editor: editors 
url: url 
access: access 
publisher: publisher 
network: networks 
last: last 
updated: updated 
original: original 
april: april 
receive: receive 
shaped: shaped 
person: person 
baldwin: baldwin 
essayist: essayist 
playwright: playwright 
novelist: novelist 
voice: voice 
civil: civil 
movement: movement 
including: including 
note: notes 
native: native 
fire: fire 
tell: tell 
mountain: mountain 
weldon: weldon 
johnson: johnson 
activist: activist 
leader: leader 
naacp: naacp 
leading: leading 
figure: figure 
creation: creation 
development: development 
harlem: harlem 
renaissance: renaissance 
garner: garner 
actor: actor 
lead: lead 
role: roles 
maverick: maverick 
rockford: rockford 
file: files 
film: films 
notebook: notebook 
washington: washington 
irving: irving 
famed: famed 
century: century 
biographical: biographical 
rip: rip 
van: van 
winkle: winkle 
legend: legend 
sleepy: sleepy 
hollow: hollow 
lovell: lovell 
jr: jr 
jim: jim 
nasa: nasa 
astronaut: astronaut 
retired: retired 
navy: navy 
captain: captain 
made: made 
historic: historic 
space: space 
flight: flights 
trip: trips 
orbiting: orbiting 
moon: moon 
commanding: commanding 
famous: famous 
apollo: apollo 
mission: mission 
joyce: joyce 
carol: carol 
oates: oates 
acclaimed: acclaimed 
like: like 
garden: garden 
earthly: earthly 
delight: delights 
fall: falls 
tom: tom 
clancy: clancy 
selling: selling 
hunt: hunt 
red: red 
october: october 
sum: sum 
fear: fears 
patriot: patriot 
game: games 
barrie: barrie 
scottish: scottish 
dramatist: dramatist 
play: play 
pan: pan 
octavia: octavia 
butler: butler 
blending: blending 
african: african 
spiritualism: spiritualism 
patternmaster: patternmaster 
kindred: kindred 
dawn: dawn 
parable: parable 
sower: sower 
loading: loading 
logo: logo 
registered: registered 
trademark: trademarks 
llc: llc 
close: close 
