naomi: naomi 
campbell: campbell 
age: age 
life: life lives 
career: career careers 
biography: biography 
skip: skip 
main: main 
content: content 
people: people 
nostalgia: nostalgia 
celebrity: celebrity 
history: history 
culture: culture 
crime: crime 
scandal: scandal 
video: video videos 
contact: contact 
u: us u 
advertise: advertise 
privacy: privacy 
notice: notice 
term: terms 
use: use 
copyright: copyright 
policy: policy 
ad: ad 
choice: choices 
accessibility: accessibility 
support: support 
setting: settings 
february: february 
subscribe: subscribe 
newsletter: newsletter 
photo: photos photo 
andreas: andreas 
rentz: rentz 
getty: getty 
image: images 
gq: gq 
quick: quick 
fact: facts fact 
name: name 
birth: birth 
date: date 
may: may 
education: education 
london: london 
academy: academy 
performing: performing 
art: arts 
italia: italia 
conti: conti 
place: place 
england: england 
zodiac: zodiac 
sign: sign 
gemini: gemini 
early: early 
cite: cite 
page: page 
publish: publish 
mar: mar 
comment: comment 
became: became 
first: first 
black: black 
woman: woman women 
appear: appear 
cover: covers cover 
french: french 
vogue: vogue 
en: en 
route: route 
iconic: iconic 
status: status 
modeling: modeling 
industry: industry 
beginning: beginning 
xa: xa 
model: model 
time: time 
also: also 
known: known 
appearance: appearances 
tv: tv 
series: series 
like: like 
face: face 
empire: empire 
scrape: scrapes 
law: law 
born: born 
daughter: daughter 
jamaican: jamaican 
dancer: dancer 
unnamed: unnamed 
father: father 
attended: attended 
dunraven: dunraven 
school: school 
youngster: youngster 
studied: studied 
stage: stage 
appeared: appeared 
music: music 
bob: bob 
marley: marley 
club: club 
signing: signing 
synchro: synchro 
agency: agency 
top: top 
supermodel: supermodels supermodel 
one: one 
world: world 
renowned: renowned 
british: british 
exquisitely: exquisitely 
exotic: exotic 
leggy: leggy 
began: began 
catwalk: catwalk 
quickly: quickly 
segued: segued 
high: high 
profile: profile 
advertising: advertising 
campaign: campaign campaigns 
fashion: fashion 
icon: icons 
ralph: ralph 
lauren: lauren 
francois: francois 
nars: nars 
posed: posed 
erotic: erotic 
fare: fare 
including: including 
playboy: playboy 
magazine: magazine 
madonna: madonna 
sex: sex 
book: book 
film: films 
endeavor: endeavors 
following: following 
rise: rise 
fame: fame 
pursued: pursued 
acting: acting 
enjoying: enjoying 
greatest: greatest 
success: success 
latter: latter 
japan: japan 
singing: singing 
peaked: peaked 
hit: hit 
love: love 
tear: tears 
though: though 
debut: debut 
album: album 
baby: baby 
sold: sold 
million: millions million 
copy: copies 
critical: critical 
flop: flop 
around: around 
several: several 
vanilla: vanilla 
ice: ice 
vehicle: vehicle 
cool: cool 
romantic: romantic 
comedy: comedy 
miami: miami 
rhapsody: rhapsody 
co: co 
authored: authored 
novel: novel 
swan: swan 
published: published 
self: self 
titled: titled 
two: two 
year: years year 
later: later 
ambitious: ambitious 
businesswoman: businesswoman 
launched: launched 
line: line 
fragrance: fragrances 
lifestyle: lifestyle 
branding: branding 
event: events event 
planning: planning 
firm: firm 
nc: nc 
connect: connect 
legal: legal 
trouble: troubles 
involved: involved 
lawsuit: lawsuit 
daily: daily 
mirror: mirror 
publishing: publishing 
leaving: leaving 
narcotic: narcotics 
anonymous: anonymous 
meeting: meeting 
appeal: appeals 
court: court 
ruled: ruled 
favor: favor 
read: read 
next: next 
bella: bella 
hadid: hadid 
sadie: sadie 
alexander: alexander 
adrienne: adrienne 
kennedy: kennedy 
reputation: reputation 
temper: temper 
arrested: arrested 
sued: sued 
committing: committing 
act: acts 
physical: physical 
violence: violence 
verbal: verbal 
abuse: abuse 
june: june 
pleaded: pleaded 
guilty: guilty 
assaulting: assaulting 
police: police 
officer: officers 
air: air 
rage: rage 
disturbance: disturbance 
plane: plane 
heathrow: heathrow 
airport: airport 
january: january 
misdemeanor: misdemeanor 
reckless: reckless 
assault: assault 
throwing: throwing 
cell: cell 
phone: phone 
maid: maid 
dispute: dispute 
missing: missing 
pair: pair 
jean: jeans 
spent: spent 
five: five 
day: days day 
mopping: mopping 
floor: floors 
new: new 
york: york 
city: city 
warehouse: warehouse 
covered: covered 
medical: medical 
expense: expenses 
ordered: ordered 
attend: attend 
anger: anger 
management: management 
program: programs program 
similar: similar 
attack: attacks attack 
employee: employee 
canada: canada 
assistant: assistant 
claimed: claimed 
threw: threw 
mobile: mobile 
threatened: threatened 
throw: throw 
moving: moving 
car: car 
paid: paid 
undisclosed: undisclosed 
sum: sum 
agreed: agreed 
class: classes 
reality: reality 
joined: joined 
craze: craze 
developing: developing 
competition: competition 
along: along 
serving: serving 
coach: coach 
producer: producer 
created: created 
version: version 
australian: australian 
television: television 
market: market 
given: given 
chance: chance 
demonstrate: demonstrate 
skill: skills 
recurring: recurring 
role: roles role 
american: american 
drama: drama 
debuted: debuted 
anthology: anthology 
horror: horror 
story: story stories 
hotel: hotel 
went: went 
another: another 
musical: musical 
star: star 
returning: returning 
judge: judge 
cut: cut 
meanwhile: meanwhile 
youtube: youtube 
channel: channel 
continued: continued 
work: work 
becoming: becoming 
cosmetic: cosmetics 
spring: spring 
philanthropy: philanthropy 
personal: personal 
close: close 
former: former 
south: south 
african: african 
president: president 
nelson: nelson 
mandela: mandela 
active: active 
promoting: promoting 
welfare: welfare 
child: children child 
africa: africa 
charity: charity 
relief: relief 
raised: raised 
dollar: dollars 
victim: victims 
catastrophic: catastrophic 
hurricane: hurricane 
katrina: katrina 
mumbai: mumbai 
terrorist: terrorist 
japanese: japanese 
earthquake: earthquake 
tsunami: tsunami 
linked: linked 
interest: interests 
mike: mike 
tyson: tyson 
robert: robert 
de: de 
niro: niro 
usher: usher 
flavio: flavio 
briatore: briatore 
bassist: bassist 
adam: adam 
clayton: clayton 
announced: announced 
welcomed: welcomed 
check: check 
strive: strive 
accuracy: accuracy 
fairness: fairness 
see: see 
something: something 
look: look 
right: right 
citation: citation 
information: information 
article: article 
title: title 
author: author 
com: com 
editor: editors 
website: website 
url: url 
access: access 
publisher: publisher 
e: e 
network: networks 
last: last 
updated: updated 
original: original 
april: april 
receive: receive 
shaped: shaped 
person: person 
kate: kate 
moss: moss 
incredibly: incredibly 
thin: thin 
boyish: boyish 
body: body 
quite: quite 
stir: stir 
launching: launching 
waif: waif 
victoria: victoria 
beckham: beckham 
rose: rose 
member: member 
spice: spice 
girl: girls girl 
successful: successful 
marriage: marriage 
soccer: soccer 
david: david 
heidi: heidi 
klum: klum 
german: german 
turned: turned 
personality: personality 
popular: popular 
show: show shows 
project: project 
runway: runway 
america: america 
got: got 
talent: talent 
elizabeth: elizabeth 
taylor: taylor 
actress: actress 
starred: starred 
cat: cat 
hot: hot 
tin: tin 
roof: roof 
butterfield: butterfield 
famous: famous 
violet: violet 
eye: eyes 
scandalous: scandalous 
stella: stella 
mccartney: mccartney 
designer: designer 
ex: ex 
beatle: beatle 
paul: paul 
late: late 
wife: wife 
linda: linda 
sharon: sharon 
osbourne: osbourne 
legendary: legendary 
rock: rock 
ozzy: ozzy 
featured: featured 
osbournes: osbournes 
talk: talk 
padma: padma 
lakshmi: lakshmi 
best: best 
host: host 
chef: chef 
jewelry: jewelry 
kitchenware: kitchenware 
eddie: eddie 
redmayne: redmayne 
actor: actor actors 
le: les 
mi: mis 
rables: rables 
danish: danish 
theory: theory 
everything: everything 
winning: winning 
lead: lead 
oscar: oscar 
laurence: laurence 
olivier: olivier 
acclaimed: acclaimed 
th: th 
century: century 
numerous: numerous 
shakespeare: shakespeare 
production: productions 
screen: screen 
well: well 
memorable: memorable 
turn: turns 
modern: modern 
classic: classics 
loading: loading 
logo: logo 
registered: registered 
trademark: trademarks 
llc: llc 
