phyllis: phyllis 
schlafly: schlafly 
quote: quotes 
era: era 
fact: facts fact 
biography: biography 
skip: skip 
main: main 
content: content 
people: people 
nostalgia: nostalgia 
celebrity: celebrity 
history: history 
culture: culture 
crime: crime 
scandal: scandal 
video: video 
contact: contact 
u: us u 
advertise: advertise 
privacy: privacy 
notice: notice 
term: terms 
use: use 
copyright: copyright 
policy: policy 
ad: ad 
choice: choices choice 
accessibility: accessibility 
support: support 
setting: settings 
february: february 
subscribe: subscribe 
newsletter: newsletter 
photo: photo 
joan: joan 
roth: roth 
hulton: hulton 
archive: archive 
getty: getty 
image: images 
quick: quick 
name: name 
birth: birth 
date: date 
august: august 
death: death 
september: september 
place: place 
st: st 
louis: louis 
missouri: missouri 
ladue: ladue 
mcalpin: mcalpin 
stewart: stewart 
cite: cite 
page: page 
defending: defending 
real: real 
right: right rights 
woman: woman women 
home: home 
wife: wife 
mother: mothers mother 
husband: husband 
let: lets 
want: want wants 
canceled: canceled 
speech: speeches 
whenever: whenever 
thought: thought 
away: away 
much: much 
simply: simply 
believe: believe 
needed: needed 
constitutional: constitutional 
amendment: amendment 
protect: protect 
find: find 
greatest: greatest 
fulfillment: fulfillment 
family: family 
man: man 
security: security 
knowing: knowing 
compete: compete 
sex: sex 
education: education 
class: classes 
like: like 
sale: sales 
party: party parties 
abortion: abortions abortion 
sexual: sexual 
harassment: harassment 
job: job 
problem: problem 
virtuous: virtuous 
getting: getting 
married: married 
consented: consented 
think: think 
call: call 
rape: rape 
atomic: atomic 
bomb: bomb 
marvelous: marvelous 
gift: gift 
given: given 
country: country 
wise: wise 
god: god 
publish: publish 
apr: apr 
comment: comment 
kept: kept 
equal: equal 
ratified: ratified 
bolstered: bolstered 
power: power 
conservative: conservatives conservative 
movement: movements movement 
united: united 
state: state states 
firebrand: firebrand 
credited: credited 
swaying: swaying 
public: public 
opinion: opinion 
preventing: preventing 
added: added 
constitution: constitution 
fight: fight 
ratify: ratify 
argued: argued 
would: would 
undermine: undermine 
stay: stay 
forcing: forcing 
military: military 
service: service 
expanding: expanding 
access: access 
leading: leading 
legalization: legalization 
marriage: marriage 
following: following 
defeat: defeat 
remained: remained 
prominent: prominent 
figure: figure 
early: early 
life: life lives 
born: born 
odile: odile 
dodge: dodge 
john: john 
bruce: bruce 
great: great 
depression: depression 
father: father 
lost: lost 
though: though 
occasional: occasional 
work: work 
supported: supported 
consisted: consisted 
younger: younger 
sister: sister 
worked: worked 
department: department 
store: store 
saleswoman: saleswoman 
teacher: teacher 
librarian: librarian 
however: however 
economic: economic 
struggle: struggles 
alter: alter 
republicanism: republicanism 
make: make 
fan: fans 
new: new 
deal: deal 
attended: attended 
academy: academy 
sacred: sacred 
heart: heart 
high: high 
school: school 
scholarship: scholarship 
maryville: maryville 
college: college 
yet: yet 
soon: soon 
opted: opted 
transfer: transfer 
academically: academically 
challenging: challenging 
washington: washington 
university: university 
attending: attending 
world: world 
war: war 
ii: ii 
meant: meant 
could: could 
night: night 
testing: testing 
ammunition: ammunition 
order: order 
earn: earn 
tuition: tuition 
money: money 
graduation: graduation 
earned: earned 
master: master 
government: government 
radcliffe: radcliffe 
working: working 
penned: penned 
article: article 
bank: bank 
attorney: attorney 
fred: fred 
jr: jr 
appreciated: appreciated 
piece: piece 
came: came 
meet: meet 
author: author 
overcoming: overcoming 
surprise: surprise 
written: written 
quickly: quickly 
fell: fell 
love: love 
couple: couple 
wed: wed 
october: october 
received: received 
law: law 
degree: degree 
initial: initial 
disapproval: disapproval 
prompted: prompted 
withdraw: withdraw 
application: application applications 
gave: gave 
permission: permission 
believed: believed 
help: help 
able: able 
pursue: pursue 
course: course 
study: study 
stop: stop 
campaign: campaign 
december: december 
friend: friend 
asked: asked 
speak: speak 
proposed: proposed 
prohibit: prohibit 
discrimination: discrimination 
basis: basis 
point: points point 
focused: focused 
threat: threat 
communism: communism 
research: research 
became: became 
opponent: opponents opponent 
formed: formed 
group: group 
acronym: acronym 
taking: taking 
privilege: privileges 
halt: halt 
ratification: ratification ratifications 
described: described 
attack: attack 
homemaker: homemaker 
subject: subject 
draft: draft 
keep: keep 
receiving: receiving 
alimony: alimony 
also: also 
result: result 
gay: gay 
unisex: unisex 
bathroom: bathrooms 
paying: paying 
tap: tap 
backlash: backlash 
among: among 
housewife: housewives 
devalued: devalued 
religious: religious 
wary: wary 
change: changes 
traditional: traditional 
structure: structures 
many: many 
motivated: motivated 
opposition: opposition 
supreme: supreme 
court: court 
decision: decision 
roe: roe 
v: v 
wade: wade 
legalized: legalized 
momentum: momentum 
seemed: seemed 
favor: favor 
began: began 
act: act 
democrat: democrats 
republican: republicans republican 
house: houses 
congress: congress 
passed: passed 
large: large 
margin: margins 
year: years year 
later: later 
meaning: meaning 
eight: eight 
become: become 
part: part 
prevent: prevent 
coordinated: coordinated 
effort: efforts 
sway: sway 
legislature: legislatures 
tutored: tutored 
talking: talking 
anti: anti 
give: give 
homemade: homemade 
bread: bread 
pie: pies 
symbolizing: symbolizing 
homemaking: homemaking 
legislator: legislators 
debated: debated 
feminist: feminists 
debate: debate 
partner: partners 
often: often 
angered: angered 
saw: saw 
lie: lies 
betty: betty 
friedan: friedan 
feminine: feminine 
mystique: mystique 
told: told 
one: one 
face: face 
offs: offs 
burn: burn 
stake: stake 
consider: consider 
traitor: traitor 
november: november 
national: national 
conference: conference 
held: held 
houston: houston 
attendee: attendees 
voiced: voiced 
discussed: discussed 
issue: issues 
reproductive: reproductive 
nuclear: nuclear 
disarmament: disarmament 
time: time 
pro: pro 
rally: rally 
event: events event 
welcomed: welcomed 
least: least 
overflow: overflow 
crowd: crowds 
astro: astro 
arena: arena 
strength: strength 
gathering: gathering 
considered: considered 
turning: turning 
january: january 
indiana: indiana 
becoming: becoming 
th: th 
followed: followed 
bill: bill 
extending: extending 
deadline: deadline 
march: march 
june: june 
still: still 
short: short 
required: required 
second: second 
five: five 
voted: voted 
rescind: rescind 
earlier: earlier 
legality: legality 
rescission: rescissions 
unclear: unclear 
celebrated: celebrated 
win: win 
hotel: hotel 
c: c 
announced: announced 
dead: dead 
forever: forever 
century: century 
lead: leads 
member: members 
opposed: opposed 
song: song songs 
force: force 
plan: plan 
demonstration: demonstration 
xa: xa 
bettmann: bettmann 
read: read 
next: next 
bella: bella 
hadid: hadid 
sadie: sadie 
alexander: alexander 
adrienne: adrienne 
kennedy: kennedy 
belief: beliefs 
staunch: staunch 
graduate: graduate 
american: american 
enterprise: enterprise 
association: association 
tank: tank 
institute: institute 
returning: returning 
hometown: hometown 
successful: successful 
congressional: congressional 
candidate: candidate 
founded: founded 
catholic: catholic 
communist: communist 
called: called 
cardinal: cardinal 
mindszenty: mindszenty 
foundation: foundation 
honor: honor 
hungarian: hungarian 
priest: priest 
persecuted: persecuted 
regime: regime 
stating: stating 
unleashed: unleashed 
vitriol: vitriol 
politician: politicians 
including: including 
weak: weak 
defense: defense 
view: views 
shared: shared 
report: report 
subscription: subscription 
launched: launched 
eagle: eagle 
forum: forum 
continued: continued 
advocate: advocate 
cause: causes 
used: used 
television: television 
appearance: appearances 
newspaper: newspaper 
column: columns 
radio: radio 
segment: segments 
decry: decry 
pornography: pornography 
immigration: immigration 
reform: reform 
every: every 
convention: convention 
barry: barry 
goldwater: goldwater 
ronald: ronald 
reagan: reagan 
stand: stand 
vocal: vocal 
made: made 
possible: possible 
presidency: presidency 
endorsed: endorsed 
donald: donald 
trump: trump 
month: months 
unsuccessful: unsuccessful 
run: runs 
illinois: illinois 
federation: federation 
recognized: recognized 
political: political 
skill: skills 
describing: describing 
darn: darn 
effective: effective 
diary: diary 
appointment: appointment 
commission: commission 
bicentennial: bicentennial 
feminism: feminism 
role: roles role 
profile: profile 
tied: tied 
idea: idea 
focus: focus 
household: household 
featured: featured 
different: different 
division: division 
labor: labor 
spearheading: spearheading 
travel: travel 
domestic: domestic 
eased: eased 
full: full 
housekeeper: housekeeper 
noticed: noticed 
variance: variance 
statement: statements 
private: private 
countered: countered 
stayed: stayed 
six: six 
child: children child 
breastfeeding: breastfeeding 
homeschooling: homeschooling 
age: age 
seven: seven 
ran: ran 
first: first 
toddler: toddler 
characterized: characterized 
hobby: hobby 
undertaken: undertaken 
opening: opening 
word: words 
thank: thank 
letting: letting 
come: come 
something: something 
said: said 
irritates: irritates 
libber: libbers 
anything: anything 
interview: interview 
stated: stated 
fill: fill 
put: put 
occupation: occupation 
evidence: evidence 
rejection: rejection 
declared: declared 
title: title 
m: ms 
misery: misery 
technical: technical 
advance: advances 
male: male 
inventor: inventors 
disposable: disposable 
diaper: diapers 
frozen: frozen 
food: foods 
done: done 
far: far 
improve: improve 
book: books book 
echo: echo 
polemic: polemic 
elite: elites 
controlling: controlling 
nomination: nomination 
process: process 
self: self 
published: published 
sold: sold 
three: three 
million: million 
copy: copies 
delegate: delegates 
influenced: influenced 
helped: helped 
senator: senator 
land: land lands 
presidential: presidential 
went: went 
lose: lose 
election: election 
president: president 
lyndon: lyndon 
b: b 
johnson: johnson 
wrote: wrote 
produced: produced 
denounced: denounced 
positive: positive 
authored: authored 
co: co 
case: case 
died: died 
personal: personal 
lived: lived 
alton: alton 
suburb: suburb 
together: together 
four: four 
son: sons 
two: two 
daughter: daughters 
lasted: lasted 
check: check 
strive: strive 
accuracy: accuracy 
fairness: fairness 
see: see 
look: look 
citation: citation 
information: information 
sara: sara 
kettler: kettler 
website: website 
com: com 
url: url 
publisher: publisher 
e: e 
network: networks 
last: last 
updated: updated 
april: april 
original: original 
receive: receive 
story: story stories 
shaped: shaped 
sign: sign 
person: person 
chuck: chuck 
berry: berry 
influential: influential 
rock: rock 
n: n 
roll: roll 
performer: performers 
music: music 
known: known 
maybellene: maybellene 
johnny: johnny 
goode: goode 
kate: kate 
chopin: chopin 
writer: writer 
novelist: novelist 
awakening: awakening 
novel: novel 
young: young 
abandon: abandons 
initially: initially 
condemned: condemned 
acclaimed: acclaimed 
lucy: lucy 
stone: stone 
activist: activist 
pioneer: pioneer 
abolitionist: abolitionist 
nancy: nancy 
former: former 
hollywood: hollywood 
actress: actress 
lady: lady 
office: office 
founder: founder 
say: say 
drug: drug 
awareness: awareness 
william: william 
clark: clark 
half: half 
famous: famous 
exploration: exploration 
team: team 
lewis: lewis 
explored: explored 
mapped: mapped 
unknown: unknown 
west: west 
mississippi: mississippi 
river: river 
julia: julia 
tv: tv 
chef: chef 
via: via 
groundbreaking: groundbreaking 
cookbook: cookbook 
mastering: mastering 
art: art 
french: french 
cooking: cooking 
popular: popular 
show: show 
maya: maya 
angelou: angelou 
civil: civil 
poet: poet 
award: award 
winning: winning 
memoir: memoir 
know: know 
caged: caged 
bird: bird 
sings: sings 
numerous: numerous 
poetry: poetry 
essay: essay 
collection: collections 
maria: maria 
mitchell: mitchell 
best: best 
professional: professional 
female: female 
astronomer: astronomer 
discovered: discovered 
comet: comet 
miss: miss 
shirley: shirley 
chisholm: chisholm 
african: african 
congresswoman: congresswoman 
major: major 
black: black 
bid: bid 
loading: loading 
logo: logo 
registered: registered 
trademark: trademarks 
llc: llc 
close: close 
