gradual: gradual 
typing: typing 
wikipedia: wikipedia 
free: free 
encyclopedia: encyclopedia 
jump: jump 
navigation: navigation 
search: search 
type: types type 
system: system systems 
mw: mw 
parser: parser 
output: output 
sidebar: sidebar 
width: width 
em: em 
float: float 
right: right 
clear: clear 
margin: margin 
background: background 
f: f 
fa: fa 
border: border 
px: px 
solid: solid 
aaa: aaa 
padding: padding 
text: text 
align: align 
center: center 
line: line 
height: height 
font: font 
size: size 
collapse: collapse 
display: display 
table: table 
body: body 
skin: skin 
minerva: minerva 
important: important 
subgroup: subgroup 
spacing: spacing 
left: left 
none: none 
outer: outer 
title: title 
weight: weight 
bold: bold 
top: top 
image: image 
caption: caption 
pretitle: pretitle 
heading: heading 
content: content contents 
bottom: bottom 
navbar: navbar 
list: list 
c: cs c 
max: max 
mediawiki: mediawiki 
general: general 
concept: concepts 
safety: safety 
strong: strong 
v: v vs 
weak: weak 
major: major 
category: categories 
static: static 
dynamic: dynamic 
manifest: manifest 
inferred: inferred 
nominal: nominal 
structural: structural 
duck: duck 
minor: minor 
abstract: abstract 
dependent: dependent 
flow: flow 
sensitive: sensitive 
intersection: intersection 
latent: latent 
refinement: refinement 
substructural: substructural 
unique: unique 
session: session 
inline: inline 
normal: normal 
boxtext: boxtext 
word: word 
ul: ul 
block: block 
white: white 
space: space 
nowrap: nowrap 
inherit: inherit 
bracket: brackets 
li: li 
span: span 
abbr: abbr 
decoration: decoration 
mini: mini 
variant: variant 
small: small 
cap: caps 
cursor: cursor 
ct: ct 
full: full 
e: e 
variable: variables variable 
expression: expressions 
may: may 
given: given 
correctness: correctness 
checked: checked 
compile: compile 
time: time 
untyped: untyped 
eventual: eventual 
error: errors error 
reported: reported 
runtime: runtime 
allows: allows 
software: software 
developer: developers 
choose: choose 
either: either 
paradigm: paradigm 
appropriate: appropriate 
within: within 
single: single 
language: language languages 
many: many 
case: cases 
added: added 
existing: existing 
creating: creating 
derived: derived 
allowing: allowing 
requiring: requiring 
used: used 
us: uses 
start: start 
history: history 
implementation: implementation 
example: examples 
reference: reference references 
reading: reading 
edit: edit 
term: term 
coined: coined 
jeremy: jeremy 
siek: siek 
walid: walid 
taha: taha 
began: began 
researching: researching 
particular: particular 
special: special 
named: named 
represent: represent 
statically: statically 
unknown: unknown 
replaces: replaces 
notion: notion 
equality: equality 
new: new 
relation: relation 
called: called 
consistency: consistency 
relates: relates 
every: every 
symmetric: symmetric 
transitive: transitive 
prior: prior 
attempt: attempts 
integrating: integrating 
tried: tried 
make: makes make 
subtype: subtype 
hierarchy: hierarchy 
however: however 
subtyping: subtyping 
result: results 
becoming: becoming 
related: related 
would: would 
longer: longer 
rule: rule 
addition: addition 
second: second seconds 
phase: phase 
plausibility: plausibility 
checking: checking 
completely: completely 
solve: solve 
problem: problems problem 
easily: easily 
integrated: integrated 
object: object objects 
oriented: oriented 
already: already 
subsumption: subsumption 
allow: allow 
implicit: implicit 
upcast: upcasts 
respect: respect 
main: main 
idea: ideas idea 
orthogonal: orthogonal 
compose: compose 
nicely: nicely 
add: add 
gradually: gradually 
typed: typed 
simply: simply 
supposed: supposed 
reflexive: reflexive 
order: order 
dynamically: dynamically 
include: include 
closure: closure 
compiler: compiler 
typescript: typescript 
javascript: javascript 
hack: hack 
php: php 
since: since 
racket: racket 
clojure: clojure 
cython: cython 
python: python 
mypy: mypy 
checker: checker 
pyre: pyre 
alternative: alternative 
cperl: cperl 
perl: perl 
actionscript: actionscript 
ecmascript: ecmascript 
though: though 
originally: originally 
arose: arose 
separately: separately 
sibling: sibling 
influenced: influenced 
apple: apple 
hypertalk: hypertalk 
j: j js 
programming: programming 
developed: developed 
adding: adding 
coercion: coercion 
propagation: propagation 
filtering: filtering 
validation: validation 
property: properties 
well: well 
applying: applying 
function: function functions 
outside: outside 
definition: definitions 
thereby: thereby 
increasing: increasing 
flexibility: flexibility 
conversely: conversely 
started: started 
version: version 
explicitly: explicitly 
marked: marked 
using: using 
dart: dart 
dylan: dylan 
raku: raku 
formerly: formerly 
implemented: implemented 
check: checks 
occur: occur 
location: locations 
value: values 
assigned: assigned 
bound: bound 
parameter: parameter 
match: match 
almost: almost 
flag: flags 
conflict: conflicts 
determine: determine 
never: never 
succeed: succeed 
objective: objective 
pointer: pointers pointer 
method: method 
call: calls call 
certain: certain 
class: class 
made: made 
declared: declared 
support: support 
generates: generates 
warning: warning 
id: id 
released: released 
superset: superset 
sound: sound 
dom: dom 
api: api 
corner: corner 
reflist: reflist 
style: style 
decimal: decimal 
column: columns column 
ol: ol 
page: page 
break: break 
inside: inside 
avoid: avoid 
upper: upper 
alpha: alpha 
roman: roman 
lower: lower 
greek: greek 
b: b 
cite: cite 
citation: citation 
wrap: wrap 
q: q 
quote: quotes 
target: target 
color: color 
rgba: rgba 
lock: lock 
linear: linear 
gradient: gradient 
transparent: transparent 
url: url 
upload: upload 
wikimedia: wikimedia 
org: org 
common: commons 
green: green 
svg: svg 
repeat: repeat 
limited: limited 
registration: registration 
gray: gray 
alt: alt 
subscription: subscription 
aa: aa 
red: red 
w: ws 
icon: icon 
wikisource: wikisource 
logo: logo 
code: code 
hidden: hidden 
visible: visible 
maint: maint 
format: format 
kern: kern 
selflink: selflink 
september: september 
functional: functional 
pdf: pdf 
scheme: scheme 
university: university 
chicago: chicago 
pp: pp 
thatte: thatte 
satish: satish 
quasi: quasi 
popl: popl 
acm: acm 
principle: principles 
doi: doi 
isbn: isbn 
oliart: oliart 
alberto: alberto 
algorithm: algorithm 
inferring: inferring 
technical: technical 
report: report 
boston: boston 
august: august 
ecoop: ecoop 
european: european 
conference: conference 
lecture: lecture 
note: notes 
computer: computer 
science: science 
vol: vol 
springer: springer 
feldthaus: feldthaus 
asger: asger 
ller: ller 
anders: anders 
interface: interfaces 
library: library libraries 
proceeding: proceedings 
international: international 
application: applications 
oopsla: oopsla 
portland: portland 
oregon: oregon 
usa: usa 
press: press 
swamy: swamy 
n: n 
fournet: fournet 
rastogi: rastogi 
bhargavan: bhargavan 
k: k 
chen: chen 
strub: strub 
p: p 
bierman: bierman 
g: g 
embedded: embedded 
securely: securely 
st: st 
sigplan: sigplan 
sigact: sigact 
symposium: symposium 
argument: arguments argument 
manual: manual 
strict: strict 
chas: chas 
emerick: emerick 
user: user 
guide: guide 
jukka: jukka 
lehtosalo: lehtosalo 
optional: optional 
performant: performant 
aseem: aseem 
avik: avik 
chaudhuri: chaudhuri 
basil: basil 
hosmer: hosmer 
january: january 
in: ins 
out: outs 
inference: inference 
association: association 
computing: computing 
machinery: machinery 
retrieved: retrieved 
msdn: msdn 
microsoft: microsoft 
appendix: appendix 
hard: hard 
february: february 
vitousek: vitousek 
michael: michael 
cimini: cimini 
matteo: matteo 
boyland: boyland 
john: john 
tang: tang 
ball: ball 
thomas: thomas 
bodik: bodik 
rastislav: rastislav 
krishnamurthi: krishnamurthi 
shriram: shriram 
lerner: lerner 
benjamin: benjamin 
morrisett: morrisett 
greg: greg 
ed: eds 
refined: refined 
criterion: criteria 
summit: summit 
advance: advances 
snapl: snapl 
leibniz: leibniz 
informatics: informatics 
lipics: lipics 
dagstuhl: dagstuhl 
germany: germany 
schloss: schloss 
zentrum: zentrum 
fuer: fuer 
informatik: informatik 
newpp: newpp 
limit: limit 
parsed: parsed 
cached: cached 
cache: cache 
expiry: expiry 
reduced: reduced 
false: false 
complication: complications 
vary: vary 
revision: revision 
sha: sha 
cpu: cpu 
usage: usage 
real: real 
preprocessor: preprocessor 
visited: visited 
node: node 
count: count 
post: post 
expand: expand 
byte: bytes 
template: template 
highest: highest 
expansion: expansion 
depth: depth 
expensive: expensive 
unstrip: unstrip 
recursion: recursion 
lua: lua 
memory: memory 
number: number 
wikibase: wikibase 
entity: entities 
loaded: loaded 
transclusion: transclusion 
m: ms 
total: total 
web: web 
short: short 
description: description 
pagetype: pagetype 
book: book 
saved: saved 
key: key 
enwiki: enwiki 
pcache: pcache 
idhash: idhash 
canonical: canonical 
timestamp: timestamp 
serialized: serialized 
json: json 
oldid: oldid 
article: articles 
different: different 
wikidata: wikidata 
menu: menu 
