skip: skip 
content: content 
href: href 
signup: signup 
ref: ref 
cta: cta 
sign: sign 
loc: loc 
header: header 
logged: logged 
page: page 
f: f 
cuser: cuser 
name: name 
e: e 
crepo: crepo 
fblob: fblob 
fshow: fshow 
source: source 
repo: repo 
class: class 
inline: inline 
block: block 
lg: lg 
none: none 
underline: underline 
border: border 
color: color 
default: default 
rounded: rounded 
px: px 
py: py 
mr: mr 
sm: sm 
fg: fg 
inherit: inherit 
data: data 
hydro: hydro 
click: click 
event: event 
type: type 
authentication: authentication 
payload: payload 
location: location 
site: site 
repository: repository 
id: id 
null: null 
auth: auth 
originating: originating 
url: url 
user: user 
hmac: hmac 
ce: ce 
cb: cb 
eae: eae 
ca: ca 
ba: ba 
cf: cf 
c: c 
