v: v 
practical: practical 
jruby: jruby 
rail: rails 
web: web 
project: projects 
bringing: bringing 
ruby: ruby 
java: java 
platform: platform 
bini: bini 
ola: ola 
free: free 
download: download 
borrow: borrow 
streaming: streaming 
internet: internet 
archive: archive 
following: following 
entire: entire 
license: license 
notice: notice 
javascript: javascript 
code: code 
page: page 
program: program 
software: software 
redistribute: redistribute 
modify: modify 
term: terms 
gnu: gnu 
affero: affero 
general: general 
public: public 
published: published 
foundation: foundation 
either: either 
version: version 
option: option 
later: later 
distributed: distributed 
hope: hope 
useful: useful 
without: without 
warranty: warranty 
even: even 
implied: implied 
merchantability: merchantability 
fitness: fitness 
particular: particular 
purpose: purpose 
see: see 
detail: details 
received: received 
copy: copy 
along: along 
window: window 
setup: setup 
schema: schema 
org: org 
breadcrumblist: breadcrumblist 
itemlistelement: itemlistelement 
listitem: listitem 
position: position 
item: item items 
text: text texts 
name: name 
image: images image 
service: services 
img: img 
skip: skip 
main: main 
content: content 
div: div 
id: id 
wrap: wrap 
itemscope: itemscope 
itemtype: itemtype 
class: class 
ia: ia 
banner: banner 
hidden: hidden 
outage: outage 
data: data 
campaign: campaign 
due: due 
planned: planned 
power: power 
friday: friday 
pm: pm 
pst: pst 
may: may 
impacted: impacted 
topnav: topnav 
basehost: basehost 
mediabasehost: mediabasehost 
username: username 
userprofilelastmodified: userprofilelastmodified 
screenname: screenname 
searchquery: searchquery 
config: config 
eyj: eyj 
cgxvywrvukwioijodhrwczpcl: cgxvywrvukwioijodhrwczpcl 
wvyxjjagl: wvyxjjagl 
z: zs z 
vcmdcl: vcmdcl 
nyzwf: nyzwf 
zsisimv: zsisimv 
zw: zw 
q: q 
f: f 
zwdvcnkioijub: zwdvcnkioijub 
boyxyilcj: boyxyilcj 
yxliywnrugfnzxnbcmnoaxzlzci: yxliywnrugfnzxnbcmnoaxzlzci 
ijy: ijy 
ncbiawxsaw: ncbiawxsaw 
uin: uin 
menu: menu menus 
eyjhdwrpbyi: eyjhdwrpbyi 
eyjozwfkaw: eyjozwfkaw 
nijoisw: nijoisw 
zxjuzxqgqxjjagl: zxjuzxqgqxjjagl 
zsbbdwrpbyisimljb: zsbbdwrpbyisimljb 
maw: maw 
rcyi: rcyi 
w: w 
siawnvbii: siawnvbii 
imh: imh 
dhbzolwvxc: dhbzolwvxc 
hcmnoaxzllm: hcmnoaxzllm 
yz: yz 
wvc: wvc 
vydmljzxncl: vydmljzxncl 
ltz: ltz 
wvzxryzwuilcj: wvzxryzwuilcj 
axrszsi: axrszsi 
ikxpdmugtxvzawmgqxjjagl: ikxpdmugtxvzawmgqxjjagl 
zsisinvybci: zsisinvybci 
ilwvzgv: ilwvzgv 
ywlsc: ywlsc 
wvzxryzwuifsx: wvzxryzwuifsx 
imljb: imljb 
ioijodhrwczpcl: ioijodhrwczpcl 
nlcnzpy: nlcnzpy 
vzxc: vzxc 
pbwdcl: pbwdcl 
xpynjpdm: xpynjpdm 
yxvkaw: yxvkaw 
ilcj: ilcj 
ikxpynjpdm: ikxpynjpdm 
iezyzwugqxvkaw: iezyzwugqxvkaw 
cmwioijcl: cmwioijcl 
rldgfpbhncl: rldgfpbhncl 
ifv: ifv 
simzlyxr: simzlyxr 
cmvktglua: cmvktglua 
miolt: miolt 
inrpdgxlijoiqwxsief: inrpdgxlijoiqwxsief 
zglviiwidxjsijoixc: zglviiwidxjsijoixc 
kzxrhawxzxc: kzxrhawxzxc 
hdwrpbyj: hdwrpbyj 
lhsidgl: lhsidgl 
bguioijuaglziep: bguioijuaglziep 
c: c 
qgsw: qgsw 
nlyxjjac: nlyxjjac 
waha: waha 
cxvlcnk: cxvlcnk 
bwvkawf: bwvkawf 
exblomf: exblomf 
zglvjnnvcnq: zglvjnnvcnq 
lxb: lxb 
ymxpy: ymxpy 
rhdguifsx: rhdguifsx 
inrpdgxlijoir: inrpdgxlijoir 
jhdgvmdwwgrgvhzcisinvybci: jhdgvmdwwgrgvhzcisinvybci 
wvr: wvr 
jhdgvmdwxezwfkin: jhdgvmdwxezwfkin 
seyj: seyj 
ik: ik 
ldgxhymvscyisinvybci: ldgxhymvscyisinvybci 
wvbmv: wvbmv 
bgfizwxzin: bgfizwxzin 
szcbuaw: szcbuaw 
lifjhzglviiwidxjsijoixc: lifjhzglviiwidxjsijoixc 
vbgr: vbgr 
aw: aw 
lcmfkaw: lcmfkaw 
ifsx: ifsx 
inrpdgxlijoinzggulbncybhbmqgq: inrpdgxlijoinzggulbncybhbmqgq 
lsaw: lsaw 
kzxigumvjb: kzxigumvjb 
jkaw: jkaw 
ncyisinvybci: ncyisinvybci 
wvnzhycg: wvnzhycg 
simxpbmtzijpbeyj: simxpbmtzijpbeyj 
ikf: ikf 
zglviejvb: zglviejvb 
tzicygug: tzicygug 
ldhj: ldhj 
iiwidxjsijoixc: iiwidxjsijoixc 
hdwrpb: hdwrpb 
ib: ib 
rc: rc 
bvzxryesj: bvzxryesj 
bguioijdb: bguioijdb 
wdxrlcnmsifrly: wdxrlcnmsifrly 
hub: hub 
xvz: xvz 
kgyw: kgyw 
kifnjawvuy: kifnjawvuy 
uilcj: uilcj 
zglvx: zglvx 
rly: rly 
gifsx: gifsx 
inrpdgxlijoitxvzawmsiefydhmgjibddwx: inrpdgxlijoitxvzawmsiefydhmgjibddwx 
dxjliiwidxjsijoixc: dxjliiwidxjsijoixc 
tdxnpyyj: tdxnpyyj 
bguioijozxdzicyguhvibgljiefmzmfpcnmilcj: bguioijozxdzicyguhvibgljiefmzmfpcnmilcj 
ld: ld 
mifsx: mifsx 
inrpdgxlijoiu: inrpdgxlijoiu 
bpcml: bpcml 
dwfsaxr: dwfsaxr 
icygumvsawdpb: icygumvsawdpb 
jlbglnaw: jlbglnaw 
ilbvzgnhc: ilbvzgnhc 
rziiwidxjsijoixc: rziiwidxjsijoixc 
wb: wb 
rjyxn: rjyxn 
cyj: cyj 
bguioijsywrpbybozxdziefyy: bguioijsywrpbybozxdziefyy 
hpdmuilcj: hpdmuilcj 
jhzglvin: jhzglvin 
dfswiaw: dfswiaw 
hz: hz 
vzijp: vzijp 
imhlywrpbmcioijjbwfnzxmilcjpy: imhlywrpbmcioijjbwfnzxmilcjpy 
utglua: utglua 
ldhjvcg: ldhjvcg 
saxrhbm: saxrhbm 
bw: bw 
myxj: myxj 
lwdhbgxlcnkilcj: lwdhbgxlcnkilcj 
saxrhbibndxnldw: saxrhbibndxnldw 
lwdhbgxlcnkifsx: lwdhbgxlcnkifsx 
nszxzlbgfuzgfydcisinrpdgxlijoiq: nszxzlbgfuzgfydcisinrpdgxlijoiq 
xldmvsyw: xldmvsyw 
kie: kie 
bsbvzibbcnqilcj: bsbvzibbcnqilcj 
nszxzlbgfuzgfydcj: nszxzlbgfuzgfydcj 
xswizmvhdhvyzwrmaw: xswizmvhdhvyzwrmaw 
sidgl: sidgl 
bguioijbbgwgsw: bguioijbbgwgsw 
vziiwidxjsijoixc: vziiwidxjsijoixc 
pbwfnzsj: pbwfnzsj 
exblomltywdljnnvcnq: exblomltywdljnnvcnq 
inrpdgxlijoirmxpy: inrpdgxlijoirmxpy 
tyienvbw: tyienvbw 
vbnmilcj: vbnmilcj 
zsawnrcmnvbw: zsawnrcmnvbw 
vbnmifsx: vbnmifsx 
inrpdgxlijoit: inrpdgxlijoit 
njdxb: njdxb 
ifdhbgwgu: ifdhbgwgu 
ryzwv: ryzwv 
iezsawnrciisinvybci: iezsawnrciisinvybci 
wvzmxpy: wvzmxpy 
tylw: tylw 
zlcibbcnqilcj: zlcibbcnqilcj 
nvdmvyyxj: nvdmvyyxj 
yxjjagl: yxjjagl 
zsj: zsj 
bguioijvu: bguioijvu 
dtie: dtie 
hchmilcj: hchmilcj 
hchnfdxnncyj: hchnfdxnncyj 
xswibglua: xswibglua 
inrpdgxlijoitkftqsbjbwfnzxmilcj: inrpdgxlijoitkftqsbjbwfnzxmilcj 
hc: hc 
eifsx: eifsx 
syxigu: syxigu 
lzdgvtienvbgxly: lzdgvtienvbgxly 
rpb: rpb 
nvbgfyc: nvbgfyc 
lzdgvty: lzdgvty 
sbgvjdglvbij: sbgvjdglvbij 
bguioijbbwvzifjlc: bguioijbbwvzifjlc 
vhcmnoienlbnrlciisinvybci: vhcmnoienlbnrlciisinvybci 
wvyw: wvyw 
lc: lc 
jlc: jlc 
vhcmnoy: vhcmnoy 
vudgvyaw: vudgvyaw 
vsawjyyxj: vsawjyyxj 
dfswibw: dfswibw 
yzsi: yzsi 
bguioijbym: bguioijbym 
dcisinvybci: dcisinvybci 
ilwvywjvdxrclyj: ilwvywjvdxrclyj 
bguioijcbg: bguioijcbg 
niiwidxjsijoiahr: niiwidxjsijoiahr 
chm: chm 
xc: xc 
cl: cl 
jsb: jsb 
cuyxjjagl: cuyxjjagl 
vcmcifsx: vcmcifsx 
inrpdgxlijoiuhjvamvjdhmilcj: inrpdgxlijoiuhjvamvjdhmilcj 
byb: byb 
ply: ply 
rzxc: rzxc 
inrpdgxlijoisgvsccisinvybci: inrpdgxlijoisgvsccisinvybci 
ilwvywjvdxrcl: ilwvywjvdxrcl 
zhcxmucghwin: zhcxmucghwin 
ikrvbmf: ikrvbmf 
ilwvzg: ilwvzg 
uyxrlp: uyxrlp 
yawdpbj: yawdpbj 
pyxd: pyxd 
dy: dy 
ub: ub 
boyxzeb: boyxzeb 
hdgvcdxr: hdgvcdxr 
b: b 
inrpdgxlijoiq: inrpdgxlijoiq 
udgfjdcisinvybci: udgfjdcisinvybci 
nvbnrhy: nvbnrhy 
qucghwin: qucghwin 
ikpvynmilcj: ikpvynmilcj 
fib: fib 
qb: qb 
jzlnboccj: jzlnboccj 
bguioijwb: bguioijwb 
x: x 
bnrlzxiilcj: bnrlzxiilcj 
bnrlzxjwb: bnrlzxjwb 
npdglvbnmucghwin: npdglvbnmucghwin 
ilblb: ilblb 
bszsisinvybci: bszsisinvybci 
jpb: jpb 
mucghwin: mucghwin 
dlcjzb: dlcjzb 
fyzsi: fyzsi 
nijoiu: nijoiu 
mdhdhcmuilcjpy: mdhdhcmuilcjpy 
ludgvybmv: ludgvybmv 
yxjjywrliiwidgl: yxjjywrliiwidgl 
bguioijjbnrlcm: bguioijjbnrlcm 
ldcbbcmnhzguilcj: ldcbbcmnhzguilcj 
yxjjywrlin: yxjjywrlin 
seyjpy: seyjpy 
uijoiahr: uijoiahr 
fyy: fyy 
hpdmuub: hpdmuub 
jnxc: jnxc 
zzxj: zzxj 
awnlc: awnlc 
wvaw: wvaw 
nxc: nxc 
jb: jb 
zb: zb 
xlbgl: xlbgl 
ncm: ncm 
vbsisinrpdgxlijoiq: vbsisinrpdgxlijoiq 
uc: uc 
szsbmaxzpbmcgum: szsbmaxzpbmcgum 
vbsisinvybci: vbsisinvybci 
wvy: wvy 
szwxpdmluz: szwxpdmluz 
jvb: jvb 
inrpdgxlijoiqwxsifnvznr: inrpdgxlijoiqwxsifnvznr 
yxjliiwidxjsijoixc: yxjliiwidxjsijoixc 
fyzsj: fyzsj 
exblonnvznr: exblonnvznr 
yxjljnnvcnq: yxjljnnvcnq 
xkifnjag: xkifnjag 
vbcbfbxvsyxrpb: vbcbfbxvsyxrpb 
rvc: rvc 
vjin: vjin 
tlurpuybhyw: tlurpuybhyw 
lcyisinvybci: lcyisinvybci 
mdhdhcmvsawjyyxj: mdhdhcmvsawjyyxj 
zzg: zzg 
zx: zx 
dhbwvzin: dhbwvzin 
ikhpc: ikhpc 
rvcmljywwgu: rvcmljywwgu 
mdhdhcmuilcj: mdhdhcmuilcj 
hpc: hpc 
rvcmljywxzb: rvcmljywxzb 
bguioijdbgfzc: bguioijdbgfzc 
ljifbdiedhbwvziiwidxjsijoixc: ljifbdiedhbwvziiwidxjsijoixc 
jbgfzc: jbgfzc 
ljcgnnyw: ljcgnnyw 
lcyj: lcyj 
bguioijtb: bguioijtb 
fyzsbmawjyyxj: fyzsbmawjyyxj 
fyzwxpynjhcnkifv: fyzwxpynjhcnkifv 
iktvzgkgqxjjagl: iktvzgkgqxjjagl 
zsbhbmqgu: zsbhbmqgu 
vwcg: vwcg 
ydcbgawxliiwidxjsijoixc: ydcbgawxliiwidxjsijoixc 
rb: rb 
rpx: rpx 
hpdmuifsx: hpdmuifsx 
inrpdgxlijoivmludgfnzsbtb: inrpdgxlijoivmludgfnzsbtb 
fyzsisinvybci: fyzsisinvybci 
wvdmludgfnzxnvznr: wvdmludgfnzxnvznr 
yxjlin: yxjlin 
ikfqsyisinvybci: ikfqsyisinvybci 
wvyxbryxjjagl: wvyxbryxjjagl 
bguioijnuy: bguioijnuy 
et: et 
milcj: milcj 
nvznr: nvznr 
yxjlbglicmfyev: yxjlbglicmfyev 
tc: tc 
rvcyj: rvcyj 
bguioijdrc: bguioijdrc 
st: st 
gu: gu 
nklxjvbxmifsx: nklxjvbxmifsx 
qtuk: qtuk 
nifnvznr: nifnvznr 
yxjliexpynjhcnkilcj: yxjliexpynjhcnkilcj 
nkcm: nkcm 
mdhdhcmuifsx: mdhdhcmuifsx 
mdhdhcmugu: mdhdhcmugu 
l: l 
zxmilcj: zxmilcj 
yxjlc: yxjlc 
zxmifsx: zxmifsx 
inrpdgxlijoivhvjb: inrpdgxlijoivhvjb 
dzifnvznr: dzifnvznr 
r: r 
bguioijtagfyzxdhcmugq: bguioijtagfyzxdhcmugq 
riynnhcmnoaxzlin: riynnhcmnoaxzlin 
ilnvznr: ilnvznr 
yxjlienhchn: yxjlienhchn 
bgvzienvbxbpbgf: bgvzienvbxbpbgf 
uiiwidxjsijoixc: uiiwidxjsijoixc 
fyzwnhchn: fyzwnhchn 
bgvzin: bgvzin 
iknelvjptsbjbwfnzxmilcj: iknelvjptsbjbwfnzxmilcj 
taw: taw 
vzin: vzin 
ilpyifnwzwn: ilpyifnwzwn 
cnvtiiwidxjsijoixc: cnvtiiwidxjsijoixc 
fyzwxpynjhcnlfenhfc: fyzwxpynjhcnlfenhfc 
bly: bly 
rydw: rydw 
inrpdgxlijoire: inrpdgxlijoire 
ptsbmzxzlbcbdrcisinvybci: ptsbmzxzlbcbdrcisinvybci 
wvzg: wvzg 
vbs: vbs 
jzhmifv: jzhmifv 
lcj: lcj 
zxh: zxh 
cyi: cyi 
nijoiqm: nijoiqm 
va: va 
milcjpy: milcjpy 
inrpdgxlijoiqm: inrpdgxlijoiqm 
mgdg: mgdg 
gqm: gqm 
ycm: ycm 
iiwiawnvbii: iiwiawnvbii 
sawjyyxj: sawjyyxj 
pbmxpynjhcnkifsx: pbmxpynjhcnkifsx 
blbibmawjyyxj: blbibmawjyyxj 
awrnzxrptc: awrnzxrptc 
wbmcilcj: wbmcilcj 
cmwioijodhrwczpcl: cmwioijodhrwczpcl 
wvb: wvb 
blbmxpynjhcnkub: blbmxpynjhcnkub 
inrpdgxlijoiqwxsiejvb: inrpdgxlijoiqwxsiejvb 
tziiwidxjsijoixc: tziiwidxjsijoixc 
rcyj: rcyj 
bguioijbbgwgvgv: bguioijbbgwgvgv 
dhmilcj: dhmilcj 
rlehrzin: rlehrzin 
ilroaxmgsnvzdcbjbiisinvybci: ilroaxmgsnvzdcbjbiisinvybci 
ilwvc: ilwvc 
vhcmnolnbocd: vhcmnolnbocd 
xdwvyet: xdwvyet 
tzwrpyxr: tzwrpyxr 
cgu: cgu 
dgv: dgv 
dhmmc: dhmmc 
ydd: ydd 
tchvibgljzgf: tchvibgljzgf 
bguioijtbwl: bguioijtbwl 
ahnvbmlhbibmawjyyxjpzxmilcj: ahnvbmlhbibmawjyyxjpzxmilcj 
ntaxroc: ntaxroc 
uawfuin: uawfuin 
ikzfrexjtksgkfvtksisinvybci: ikzfrexjtksgkfvtksisinvybci 
wvzmvkbgluayj: wvzmvkbgluayj 
bguioijhzw: bguioijhzw 
lywxvz: lywxvz 
kilcj: kilcj 
dlbmvhbg: dlbmvhbg 
nesj: nesj 
bguioijmaw: bguioijmaw 
xuienvbgxly: xuienvbgxly 
xpbmnvbg: xpbmnvbg 
xszwn: xszwn 
dlcjsaw: dlcjsaw 
bguioijbbwvyawnhbibmawjyyxjpzxmilcj: bguioijbbwvyawnhbibmawjyyxjpzxmilcj 
ftzxjpy: ftzxjpy 
fuysj: fuysj 
bguioijdyw: bguioijdyw 
hzglhbibmawjyyxjpzxmilcj: hzglhbibmawjyyxjpzxmilcj 
rvcm: rvcm 
udg: udg 
inrpdgxlijoivw: inrpdgxlijoivw 
pdmvyc: pdmvyc 
fsiexpynjhcnkilcj: fsiexpynjhcnkilcj 
vuaxzlcnnhbgxpynjhcnkifsx: vuaxzlcnnhbgxpynjhcnkifsx 
inrpdgxlijoiuhjvamvjdcbhdxrlbmjlcmcilcj: inrpdgxlijoiuhjvamvjdcbhdxrlbmjlcmcilcj 
dgvuymvyzyj: dgvuymvyzyj 
bguioijdaglszhjlbidziexpynjhcnkilcj: bguioijdaglszhjlbidziexpynjhcnkilcj 
lhy: lhy 
wifsx: wifsx 
inrpdgxlijoiqmlvzgl: inrpdgxlijoiqmlvzgl 
zxjzaxr: zxjzaxr 
iehlcml: iehlcml 
ywdliexpynjhcnkilcj: ywdliexpynjhcnkilcj 
rpdmvyc: rpdmvyc 
esj: esj 
bguioijcb: bguioijcb 
rcybiesbmyw: rcybiesbmyw 
ndwfnzsisinvybci: ndwfnzsisinvybci 
wvym: wvym 
niewxhbmd: niewxhbmd 
ywdlin: ywdlin 
ikjvb: ikjvb 
tzigj: tzigj 
iexhbmd: iexhbmd 
ywdliiwidxjsijoixc: ywdliiwidxjsijoixc 
j: j 
bgfuz: bgfuz 
vhz: vhz 
uifsx: uifsx 
inrpdgxlijoiqwrkaxrpb: inrpdgxlijoiqwrkaxrpb 
hbcbdb: hbcbdb 
ucyisinvybci: ucyisinvybci 
wvywrkaxrpb: wvywrkaxrpb 
hbf: hbf 
ucyj: ucyj 
xx: xx 
sindlyii: sindlyii 
eyjtb: eyjtb 
jpbgvbchbztglua: jpbgvbchbztglua 
invybci: invybci 
hchbzlmfwcgxllmnvbvwvdxncl: hchbzlmfwcgxllmnvbvwvdxncl 
fwcfwvd: fwcfwvd 
ymfjay: ymfjay 
tywnoaw: tywnoaw 
lxc: lxc 
pzdeymde: pzdeymde 
odgzmtmilcj: odgzmtmilcj 
ildhewjhy: ildhewjhy 
sgtwfjagluzsaoau: sgtwfjagluzsaoau 
tksisimv: tksisimv 
dgvybmfsijp: dgvybmfsijp 
cnvlfsx: cnvlfsx 
wbgf: wbgf 
lmdvb: lmdvb 
dszs: dszs 
n: n 
jlxc: jlxc 
hchbzxc: hchbzxc 
kzxrhawxzp: kzxrhawxzp 
lkpwnvbs: lkpwnvbs 
hcmnoaxzllndhewjhy: hcmnoaxzllndhewjhy 
ttywnoaw: ttywnoaw 
ljmhspwvux: ljmhspwvux 
vtiiwidgl: vtiiwidgl 
bguioijxyxliywnrie: bguioijxyxliywnrie 
hy: hy 
hpbmugkefuzhjvawqpiiwizxh: hpbmugkefuzhjvawqpiiwizxh 
zxjuywwionrydwv: zxjuywwionrydwv 
xswiynjvd: xswiynjvd 
nlckv: nlckv 
dgvuc: dgvuc 
lvbnnmaw: lvbnnmaw 
sidxjsijoiahr: sidxjsijoiahr 
nocm: nocm 
tzs: tzs 
nb: nb 
nbguuy: nbguuy 
txc: txc 
zwjzdg: zwjzdg 
yzvwvzgv: yzvwvzgv 
ywlsxc: ywlsxc 
yxliywnrlw: yxliywnrlw 
hpbmvcl: hpbmvcl 
zwbm: zwbm 
nzgthymttbmfky: nzgthymttbmfky 
pwzwhtbgxsa: pwzwhtbgxsa 
kcgttawfriiwidgl: kcgttawfriiwidgl 
bguioijdahjvbwuilcjlehrlcm: bguioijdahjvbwuilcjlehrlcm 
hbci: hbci 
dhj: dhj 
wvywrkb: wvywrkb 
zlm: zlm 
vemlsbgeub: vemlsbgeub 
lbi: lbi 
vu: vu 
wvzmlyzwzvefwvywrkb: wvzmlyzwzvefwvywrkb 
dhewjhy: dhewjhy 
stbwfjagluzv: stbwfjagluzv 
uzxdclyisinrpdgxlijoirmlyzwzvecisimv: uzxdclyisinrpdgxlijoirmlyzwzvecisimv 
pzde: pzde 
nzi: nzi 
mzi: mzi 
mji: mji 
bxq: bxq 
mtiilcj: mtiilcj 
ilnhzmfyasisimv: ilnhzmfyasisimv 
cnvlfv: cnvlfv 
simfyy: simfyy 
hpdmvjdexpbmtzijpbeyj: hpdmvjdexpbmtzijpbeyj 
wvd: wvd 
lmfyy: lmfyy 
hpdmutaxqub: hpdmutaxqub 
lehbsb: lehbsb 
jliiwidgl: jliiwidgl 
bguioijfehbsb: bguioijfehbsb 
jlihrozsbdb: jlihrozsbdb 
lhsidxjsijoiahr: lhsidxjsijoiahr 
hcmnoaxzllwl: hcmnoaxzllwl 
lm: lm 
wvymxvz: wvymxvz 
wvbgvhcm: wvbgvhcm 
tbw: tbw 
yzvwviiwidgl: yzvwviiwidgl 
bguioijmzwfybibnb: bguioijmzwfybibnb 
jlin: jlin 
ywn: ywn 
lxvziiwidgl: lxvziiwidgl 
bguioijcdwlszcbdb: bguioijcdwlszcbdb 
sinzpzgvvijp: sinzpzgvvijp 
imhlywrpbmcioijwawrlbyisimljb: imhlywrpbmcioijwawrlbyisimljb 
wvdhyilcj: wvdhyilcj 
ilrwie: ilrwie 
mteilcj: mteilcj 
ilvuzgvyc: ilvuzgvyc 
rhbmrpbmcgovwvmteilcj: rhbmrpbmcgovwvmteilcj 
rldgfpbhnclzkxmsj: rldgfpbhnclzkxmsj 
bguioijbbgwgvmlkzw: bguioijbbgwgvmlkzw 
vdmllcyj: vdmllcyj 
exblom: exblom 
vdmllcyzzb: vdmllcyzzb 
p: ps 
wdwjsawnkyxrlin: wdwjsawnkyxrlin 
ilbyzwxpbmdlcibbcmnoaxzlcyisinvybci: ilbyzwxpbmdlcibbcmnoaxzlcyisinvybci 
wvchjlbgluz: wvchjlbgluz 
vyin: vyin 
ikrlbw: ikrlbw 
jcmfjesbob: jcmfjesbob 
chiiwidxjsijoixc: chiiwidxjsijoixc 
kzw: kzw 
vy: vy 
jhy: jhy 
lfbm: lfbm 
zpzcj: zpzcj 
bguioijpy: bguioijpy 
chkgv: chkgv 
fsbcbtdhjlzxqilcj: fsbcbtdhjlzxqilcj 
jy: jy 
vwexdhbgxzdhjlzxqifsx: vwexdhbgxzdhjlzxqifsx 
inrpdgxlijoivfygtlnbiensaxagtglicmfyesisinvybci: inrpdgxlijoivfygtlnbiensaxagtglicmfyesisinvybci 
wvbnnhin: wvbnnhin 
bguioijbbmltyxrpb: bguioijbbmltyxrpb 
gjibdyxj: gjibdyxj 
pbwf: pbwf 
uyw: uyw 
ky: ky 
fydg: fydg 
inrpdgxlijoiqxj: inrpdgxlijoiqxj 
cyamie: cyamie 
ljiiwidxjsijoixc: ljiiwidxjsijoixc 
hcnrzyw: hcnrzyw 
kbxvzawn: kbxvzawn 
awrlb: awrlb 
tchv: tchv 
zxjzicygvgvjag: zxjzicygvgvjag 
vbg: vbg 
nesisinvybci: nesisinvybci 
zxjzyw: zxjzyw 
kdgvjahzpzgvvcyj: kdgvjahzpzgvvcyj 
bguioijddwx: bguioijddwx 
dxjhbcamiefjywrlbwljiezpbg: dxjhbcamiefjywrlbwljiezpbg 
ziiwidxjsijoixc: ziiwidxjsijoixc 
jdwx: jdwx 
dxjhbgfuzgfjywrlbwljzmlsbxmifsx: dxjhbgfuzgfjywrlbwljzmlsbxmifsx 
inrpdgxlijoirxbozw: inrpdgxlijoirxbozw 
lcmfsiezpbg: lcmfsiezpbg 
lcghlbwvyysj: lcghlbwvyysj 
bguioijnb: bguioijnb 
zpzxmilcj: zpzxmilcj 
vdmllc: vdmllc 
fuzgzpbg: fuzgzpbg 
zin: zin 
mgjibqdwjsawmgqwzmywlycyisinvybci: mgjibqdwjsawmgqwzmywlycyisinvybci 
fuzhb: fuzhb 
fmzmfpcnmifsx: fmzmfpcnmifsx 
nwaxjpdhvhbgl: nwaxjpdhvhbgl 
ewfuzhjlbglnaw: ewfuzhjlbglnaw 
ilnwb: ilnwb 
cybwawrlb: cybwawrlb 
nwb: nwb 
bguioijuzwxldmlzaw: bguioijuzwxldmlzaw 
zwxldmlzaw: zwxldmlzaw 
ilzpzgvvz: ilzpzgvvz 
ftzsbwawrlb: ftzsbwawrlb 
dhbwv: dhbwv 
inrpdgxlijoivmxvz: inrpdgxlijoivmxvz 
zsb: zsb 
dzin: dzin 
illvdxroie: illvdxroie 
lzglhiiwidxjsijoixc: lzglhiiwidxjsijoixc 
af: af 
tzwrpysj: tzwrpysj 
sinvzzxiioltdlcjzawduzwrpdxqiolt: sinvzzxiioltdlcjzawduzwrpdxqiolt 
ilwvywnjb: ilwvywnjb 
vudfwvc: vudfwvc 
lnbnvwiiwidgl: lnbnvwiiwidgl 
bguioijtawduihvwigzvcibmcmvliiwiyw: bguioijtawduihvwigzvcibmcmvliiwiyw 
hbhl: hbhl 
awnzrxzlbnqioijbdmf: awnzrxzlbnqioijbdmf 
yxjnzw: yxjnzw 
lvnpz: lvnpz 
ccj: ccj 
lhsidxjsijoixc: lhsidxjsijoixc 
nvdw: nvdw 
sb: sb 
dpbiisinrpdgxlijoitg: dpbiisinrpdgxlijoitg 
nigluiiwiyw: nigluiiwiyw 
luxvz: luxvz 
luin: luin 
dfq: dfq 
icon: icon 
hamburger: hamburger 
svg: svg 
display: display 
block: block 
fill: fill 
color: color 
fff: fff 
login: login 
button: button 
dropdown: dropdown 
toggle: toggle 
height: height 
rem: rem 
font: font 
size: size 
transform: transform 
uppercase: uppercase 
decoration: decoration 
none: none 
ccc: ccc 
cursor: cursor 
pointer: pointer 
active: active 
focus: focus 
hover: hover 
border: border 
radius: radius 
background: background 
span: span 
inherit: inherit 
min: min 
width: width 
px: px 
logged: logged 
toolbar: toolbar 
translatey: translatey 
transparent: transparent 
inline: inline 
vertical: vertical 
align: align 
middle: middle 
nav: nav 
search: search 
input: input 
outline: outline 
padding: padding 
top: top 
margin: margin 
right: right 
relative: relative 
activated: activated 
webkit: webkit 
box: box 
m: ms 
flexbox: flexbox 
flex: flex 
absolute: absolute 
bottom: bottom 
left: left 
index: index 
inactive: inactive 
highlight: highlight 
center: center 
grid: grid 
row: rows row 
self: self 
field: field 
sizing: sizing 
fade: fade 
opacity: opacity 
animation: animation 
forward: forwards 
path: path 
static: static 
orient: orient 
horizontal: horizontal 
direction: direction 
reverse: reverse 
calc: calc 
medium: media 
label: label 
weight: weight 
pack: pack 
justify: justify 
selected: selected 
donate: donate 
auto: auto 
ffcd: ffcd 
faab: faab 
video: video 
audio: audio 
adef: adef 
ecc: ecc 
aa: aa 
vh: vh 
overflow: overflow 
tx: tx 
slide: slide 
transition: transition 
property: property 
duration: duration 
timing: timing 
function: function 
ease: ease 
open: open 
closed: closed 
group: group 
line: line 
normal: normal 
primary: primary 
template: template 
area: areas area 
empty: empty 
user: user 
column: columns column 
minmax: minmax 
solid: solid 
link: link links 
home: home 
translate: translate 
start: start 
end: end 
logo: logo 
wordmark: wordmark 
trigger: trigger 
upload: upload 
info: info 
stretch: stretch 
float: float 
bca: bca 
style: style 
initial: initial 
advanced: advanced 
visible: visible 
shadow: shadow 
rgba: rgba 
currentcolor: currentcolor 
subnav: subnav 
h: h 
ul: ul 
list: list 
li: li 
space: space 
evenly: evenly 
white: white 
nowrap: nowrap 
ellipsis: ellipsis 
featured: featured 
wayback: wayback 
max: max 
repeat: repeat 
gap: gap 
flow: flow 
nth: nth 
child: child 
slider: slider 
clip: clip 
information: information 
desktop: desktop 
aaa: aaa 
signed: signed 
vw: vw 
divider: divider 
em: em 
family: family 
helvetica: helvetica 
neue: neue 
arial: arial 
sans: sans 
serif: serif 
close: close 
layer: layer 
fixed: fixed 
body: body 
unresolved: unresolved 
