pascal: pascals pascal 
programming: programming 
language: language languages 
wikipedia: wikipedia 
free: free 
encyclopedia: encyclopedia 
jump: jump 
navigation: navigation 
search: search 
suggested: suggested 
vsi: vsi 
merged: merged 
article: articles article 
discus: discuss 
proposed: proposed 
since: since 
february: february 
mw: mw 
parser: parser 
output: output 
hatnote: hatnote 
font: font 
style: styles style 
italic: italic 
div: div 
padding: padding 
left: left 
em: em 
margin: margin 
bottom: bottom 
normal: normal 
link: link links 
top: top 
us: uses 
see: see 
disambiguation: disambiguation 
infobox: infobox 
subbox: subbox 
border: border 
none: none 
px: px 
width: width 
auto: auto 
min: min 
size: sizes size 
clear: clear 
float: float 
background: background 
color: color 
transparent: transparent 
col: cols 
child: child 
navbar: navbar 
body: body 
skin: skin 
minerva: minerva 
header: header 
subheader: subheader 
title: title 
image: image 
full: full 
data: data 
text: text 
align: align 
center: center 
paradigm: paradigm 
imperative: imperative 
structured: structured 
family: family 
wirth: wirth 
designed: designed 
niklaus: niklaus 
first: first 
appeared: appeared 
year: year years 
ago: ago 
typing: typing 
discipline: discipline 
static: static 
strong: strong 
safe: safe 
scope: scope 
lexical: lexical 
filename: filename 
extension: extensions extension 
pp: pp 
pa: pas 
inc: inc 
major: major 
implementation: implementations implementation 
cdc: cdc 
embarcadero: embarcadero 
delphi: delphi 
icl: icl 
p: p 
pdp: pdp 
ibm: ibm 
system: system systems 
gnu: gnu 
dialect: dialects dialect 
lazarus: lazarus 
turbo: turbo 
ucsd: ucsd 
influenced: influenced 
algol: algol 
w: w ws 
simula: simula 
ada: ada 
c: cs c 
al: al 
component: component components 
go: go 
java: java 
modula: modula 
oberon: oberon 
object: object objects 
oxygene: oxygene 
power: power 
fx: fx 
seed: seed 
standard: standard standards 
ml: ml 
vhdl: vhdl 
procedural: procedural 
small: small 
efficient: efficient 
intended: intended 
encourage: encourage 
good: good 
practice: practice practices 
using: using 
structuring: structuring 
named: named 
honour: honour 
french: french 
mathematician: mathematician 
philosopher: philosopher 
physicist: physicist 
blaise: blaise 
based: based 
book: books book 
algorithm: algorithms 
structure: structures structure 
program: program programs 
developed: developed 
pattern: pattern 
involved: involved 
process: process 
improve: improve 
part: parts part 
x: x 
effort: efforts 
version: versions version 
accepted: accepted 
bogged: bogged 
decided: decided 
abandon: abandon 
releasing: releasing 
scalar: scalars 
array: arrays array 
enables: enables 
defining: defining 
complex: complex 
datatypes: datatypes 
building: building 
dynamic: dynamic 
recursive: recursive 
list: list lists 
tree: trees 
graph: graphs 
mean: means 
one: ones one 
type: types type 
cannot: cannot 
converted: converted 
interpreted: interpreted 
another: another 
without: without 
explicit: explicit 
conversion: conversions conversion 
unlike: unlike 
allows: allows 
nested: nested 
procedure: procedure procedures 
definition: definitions definition 
level: level 
depth: depth 
also: also 
kind: kind kinds 
declaration: declarations declaration 
inside: inside 
subroutine: subroutines 
function: function functions 
thus: thus 
syntactically: syntactically 
similar: similar 
single: single 
block: block 
restricted: restricted 
arbitrary: arbitrary 
statement: statement statements 
became: became 
successful: successful 
notably: notably 
burgeoning: burgeoning 
minicomputer: minicomputer minicomputers 
market: market 
compiler: compilers compiler 
available: available 
many: many 
microcomputer: microcomputers microcomputer 
field: field fields 
emerged: emerged 
late: late 
widely: widely 
used: used 
teaching: teaching 
university: university universities 
course: courses 
production: production 
setting: settings 
writing: writing 
commercial: commercial 
software: software 
period: period 
displaced: displaced 
early: early 
unix: unix 
popular: popular 
especially: especially 
release: release 
derivative: derivatives derivative 
oriented: oriented 
apple: apple 
computer: computers computer 
borland: borland 
later: later 
microsoft: microsoft 
window: windows window 
platform: platforms platform 
concept: concept concepts 
led: led 
content: content contents 
history: history 
earlier: earlier 
variant: variants variant 
construct: constructs construct 
subrange: subrange 
set: sets set 
union: unions union 
file: files file 
pointer: pointers pointer 
control: control controls 
semicolon: semicolons semicolon 
separator: separator separators 
resource: resources resource 
interpreter: interpreters interpreter 
ides: ides 
library: library libraries 
iso: iso 
iec: iec 
extended: extended 
variation: variations 
like: like 
related: related 
reception: reception 
criticism: criticisms criticism 
reference: reference references 
reading: reading 
edit: edit 
much: much 
design: design 
traced: traced 
goal: goals goal 
able: able 
clearly: clearly 
describe: describe 
included: included 
number: number numbers 
feature: features feature 
remain: remain 
common: common commons 
day: day 
shortly: shortly 
introduction: introduction 
began: began 
working: working 
dissertation: dissertation 
helmut: helmut 
weber: weber 
euler: euler 
syntax: syntax 
primary: primary 
add: adds add 
allowing: allowing 
role: roles 
lisp: lisp 
published: published 
time: time times 
problem: problems problem 
identified: identified 
lack: lack 
standardized: standardized 
string: string strings 
group: group 
tasked: tasked 
maintaining: maintaining 
begun: begun 
identify: identify 
improvement: improvements 
calling: calling 
submission: submissions 
tony: tony 
hoare: hoare 
submitted: submitted 
conservative: conservative 
modification: modifications 
clean: clean 
considered: considered 
minor: minor 
worth: worth 
new: new 
wrote: wrote 
would: would 
choose: choose 
complexity: complexity 
considerable: considerable 
difficulty: difficulty 
producing: producing 
high: high 
performance: performance 
industry: industry 
opening: opening 
newer: newer 
fashion: fashion 
development: development 
generation: generation 
student: students 
introductory: introductory 
undergraduate: undergraduate 
success: successes 
ran: ran 
custom: custom 
operating: operating 
could: could 
ported: ported 
different: different 
key: key 
ii: ii 
saw: saw 
widespread: widespread 
use: use 
becoming: becoming 
lisa: lisa 
macintosh: macintosh 
original: original 
hand: hand 
translated: translated 
motorola: motorola 
assembly: assembly 
source: source sources 
code: code 
typesetting: typesetting 
tex: tex 
donald: donald 
e: e 
knuth: knuth 
written: written 
web: web 
literate: literate 
dec: dec 
application: applications application 
adobe: adobe 
photoshop: photoshop 
programmer: programmer programmers 
workshop: workshop 
total: total 
commander: commander 
skype: skype 
macromedia: macromedia 
captivate: captivate 
apollo: apollo 
beginning: beginning 
everything: everything 
research: research 
project: project projects 
pc: pcs pc 
game: games 
embedded: embedded 
exist: exist 
work: work 
larry: larry 
tesler: tesler 
corresponding: corresponding 
idea: idea 
adding: adding 
initially: initially 
clascal: clascal 
introduced: introduced 
faded: faded 
replaced: replaced 
created: created 
mac: mac 
macapp: macapp 
framework: framework 
main: main 
added: added 
basis: basis 
still: still 
developing: developing 
cross: cross 
compile: compile 
open: open 
alternative: alternative 
graphical: graphical 
ide: ide 
called: called 
z: z 
rich: rich 
series: series 
mainframe: mainframes mainframe 
report: report reports 
attempt: attempt 
implement: implements implement 
fortran: fortran 
unsuccessful: unsuccessful 
due: due 
inadequacy: inadequacy 
express: express 
second: second seconds 
implemented: implemented 
scallop: scallop 
max: max 
engeli: engeli 
r: r 
schild: schild 
boot: boot 
strapping: strapping 
operational: operational 
mid: mid 
similarly: similarly 
self: self 
hosting: hosting 
usually: usually 
capable: capable 
recompiling: recompiling 
environment: environment 
notable: notable 
exception: exception 
port: port 
completed: completed 
welsh: welsh 
quinn: quinn 
queen: queen 
belfast: belfast 
qub: qub 
target: target 
international: international 
limited: limited 
turn: turn 
parent: parent 
information: information 
ic: ics 
multum: multum 
view: view 
findlay: findlay 
cupples: cupples 
cavouras: cavouras 
davis: davis 
department: department 
computing: computing 
science: science 
glasgow: glasgow 
thought: thought 
summer: summer 
may: may 
bit: bit bits 
completely: completely 
et: et 
offered: offered 
diagnostic: diagnostic 
incorporating: incorporating 
profiling: profiling 
tracing: tracing 
aware: aware 
formatted: formatted 
postmortem: postmortem 
dump: dumps 
watt: watt 
team: team 
southampton: southampton 
model: model 
adapted: adapted 
hay: hay 
manchester: manchester 
check: check 
rigorously: rigorously 
conformity: conformity 
bsi: bsi 
generate: generate 
portable: portable 
abstract: abstract 
machine: machine machines 
north: north 
america: america 
constructed: constructed 
illinois: illinois 
b: bs b 
gillie: gillies 
generated: generated 
native: native 
propagate: propagate 
rapidly: rapidly 
porting: porting 
kit: kit 
virtual: virtual 
stack: stacks stack 
lends: lends 
reasonably: reasonably 
interpretation: interpretation 
along: along 
last: last 
come: come comes 
termed: termed 
coined: coined 
fact: fact 
existed: existed 
redesigned: redesigned 
enhance: enhance 
portability: portability 
issued: issued 
enhanced: enhanced 
become: become 
intermediate: intermediate 
backward: backward 
compatible: compatible 
run: run runs 
compiled: compiled 
however: however 
accepts: accepts 
subset: subset 
outside: outside 
includes: includes 
compatibility: compatibility 
branched: branched 
kenneth: kenneth 
bowles: bowles 
create: create 
interpretive: interpretive 
three: three 
launch: launch 
personal: personal 
byte: byte bytes 
value: values value 
earliest: earliest 
bytecode: bytecode 
rather: rather 
word: word words 
length: lengths length 
binary: binary 
released: released 
australian: australian 
atomic: atomic 
energy: energy 
commission: commission 
aaec: aaec 
abbreviation: abbreviation 
name: names name 
mpw: mpw 
consultation: consultation 
defined: defined 
incorporated: incorporated 
anders: anders 
hejlsberg: hejlsberg 
blue: blue 
label: labels label 
nascom: nascom 
reimplementation: reimplementation 
marketed: marketed 
compas: compas 
polypascal: polypascal 
acquired: acquired 
renamed: renamed 
hugely: hugely 
thanks: thanks 
aggressive: aggressive 
pricing: pricing 
strategy: strategy 
screen: screen 
fast: fast 
turnaround: turnaround 
highly: highly 
optimized: optimized 
entirely: entirely 
making: making 
smaller: smaller 
faster: faster 
competition: competition 
back: back 
large: large 
influence: influence 
community: community 
concentrating: concentrating 
mainly: mainly 
hobbyist: hobbyists 
replacement: replacement 
basic: basic 
product: products product 
adopted: adopted 
professional: professional 
developer: developers 
around: around 
imported: imported 
let: let 
interface: interface 
api: api 
directly: directly 
null: null 
terminated: terminated 
arithmetic: arithmetic 
address: addresses address 
operator: operators operator 
unsafe: unsafe 
typecasts: typecasts 
unit: unit 
module: modules module 
modular: modular 
provide: provide 
qualified: qualified 
import: import 
export: export 
specific: specific 
symbol: symbols 
super: super 
non: non 
numeric: numeric 
return: return 
expression: expressions 
tmt: tmt 
do: dos 
protected: protected 
mode: mode modes 
o: os 
win: win 
allow: allow 
overloading: overloading 
wisconsin: wisconsin 
madison: madison 
karlsruhe: karlsruhe 
wuppertal: wuppertal 
sc: sc 
xsc: xsc 
scientific: scientific 
computation: computations computation 
aimed: aimed 
numerical: numerical 
started: started 
supporting: supporting 
support: support supports 
stage: stage 
originally: originally 
targeted: targeted 
processor: processor processors 
rewritten: rewritten 
various: various 
linux: linux 
sunos: sunos 
hp: hp 
ux: ux 
aix: aix 
emx: emx 
operates: operates 
generating: generating 
executable: executable 
sol: sol 
parameterized: parameterized 
bound: bounds bound 
allowed: allowed 
keywords: keywords 
predefined: predefined 
identifier: identifier identifiers 
ease: ease 
g: g 
equivalent: equivalent 
lseek: lseek 
moved: moved 
chorusos: chorusos 
distributed: distributed 
ip: ip 
micropolis: micropolis 
cp: cp 
running: running 
exists: exists 
today: today 
xp: xp 
brought: brought 
resulting: resulting 
pascaline: pascaline 
calculator: calculator 
namespace: namespace 
generally: generally 
functionality: functionality 
protection: protection 
form: forms form 
purely: purely 
traditional: traditional 
reserved: reserved 
else: else 
case: case cases 
ranging: ranging 
begin: begin 
end: ends end 
record: record records 
enumeration: enumerations enumeration 
inherited: inherited 
inspired: inspired 
suggestion: suggestions 
start: start 
keyword: keyword 
external: external 
descriptor: descriptors 
parameter: parameter parameters 
required: required 
etc: etc 
follows: follows 
bracketed: bracketed 
separate: separate 
stop: stop 
whole: whole 
letter: letter 
ignored: ignored 
example: examples example 
simple: simple 
hello: hello 
world: world 
helloworld: helloworld 
write: write 
several: several 
defines: defines 
variable: variables variable 
way: way ways 
range: range 
storing: storing 
operation: operations 
permissible: permissible 
performed: performed 
integer: integer 
real: real 
floating: floating 
point: points point 
boolean: boolean 
true: true 
false: false 
char: char chars 
character: characters character 
ordered: ordered 
packed: packed 
countable: countable 
preceding: preceding 
sequence: sequence sequences 
access: access 
individual: individual 
referencing: referencing 
possible: possible 
except: except 
provided: provided 
following: following 
round: round rounds 
banker: banker 
rounding: rounding 
trunc: trunc 
towards: towards 
zero: zero 
freedom: freedom 
define: define 
commonly: commonly 
term: terms 
facility: facility 
signed: signed 
often: often 
already: already 
subranges: subranges 
ordinal: ordinal 
made: made 
var: var 
contrast: contrast 
fundamental: fundamental 
modern: modern 
mathematics: mathematics 
useful: useful 
executes: executes 
contiguous: contiguous 
particularly: particularly 
readability: readability 
involve: involve 
domain: domains 
improved: improved 
achieved: achieved 
representing: representing 
vector: vectors vector 
efficiently: efficiently 
bitwise: bitwise 
excerpt: excerpt excerpts 
hat: hat 
editsection: editsection 
section: section sections 
two: two 
nonstandard: nonstandard 
declaring: declaring 
absolute: absolute 
meaning: meaning 
placed: placed 
memory: memory 
location: location 
purpose: purposes 
show: shows 
element: element elements 
map: maps 
assigned: assigned 
exact: exact 
share: share 
others: others 
tsystemtime: tsystemtime 
month: month 
dayofweek: dayofweek 
hour: hour 
minute: minute 
millisecond: millisecond 
tperson: tperson 
firstname: firstname 
lastname: lastname 
birthdate: birthdate 
ispregnant: ispregnant 
datedue: datedue 
isplanningpregnancy: isplanningpregnancy 
extra: extra 
strictly: strictly 
shown: shown 
every: every 
buffer: buffer 
denoted: denoted 
f: f 
get: get 
put: put 
move: move 
next: next 
read: read 
inspecting: inspecting 
digit: digit 
lead: leads 
serious: serious 
interactive: interactive 
solved: solved 
lazy: lazy 
jensen: jensen 
represented: represented 
therefore: therefore 
fixed: fixed 
space: space 
padded: padded 
pnode: pnode 
node: node 
nodeptr: nodeptr 
intptr: intptr 
declared: declared 
forward: forward 
rule: rule 
thing: things 
must: must 
assign: assign 
initialise: initialise 
nil: nil 
done: done 
refer: refer 
subfields: subfields 
linked: linked 
queue: queue queues 
including: including 
dynamically: dynamically 
anonymous: anonymous 
local: local 
associated: associated 
help: help helps 
eliminate: eliminate 
security: security 
issue: issue issues 
inherent: inherent 
pl: pl 
remove: removes 
risk: risks risk 
caused: caused 
dangling: dangling 
ability: ability 
deallocate: deallocate 
referenced: referenced 
dispose: dispose 
effect: effects effect 
found: found 
eliminated: eliminated 
automatic: automatic 
garbage: garbage 
collection: collection 
leak: leaks 
restriction: restrictions 
lifted: lifted 
flow: flow 
goto: goto 
command: commands 
writeln: writeln 
waiting: waiting 
condition: condition conditions 
met: met 
detach: detach 
iteration: iteration 
repeat: repeat 
side: side 
whereas: whereas 
printing: printing 
printaninteger: printaninteger 
j: j 
triple: triple 
const: const 
logical: logical 
outermost: outermost 
default: default 
passed: passed 
precedes: precedes 
constant: constants 
order: order 
ordering: ordering 
requirement: requirement 
pas: pass 
compilation: compilation 
strict: strict 
relaxed: relaxed 
terminator: terminator 
needed: needed 
presence: presence 
permitted: permitted 
addition: addition 
empty: empty 
revised: revised 
change: changes 
optional: optional 
immediately: immediately 
ifs: ifs 
avoid: avoid 
inner: inner 
outer: outer 
putatively: putatively 
terminating: terminating 
instead: instead 
terminates: terminates 
clause: clauses 
general: general 
formerly: formerly 
codegear: codegear 
flagship: flagship 
rapid: rapid 
rad: rad 
descended: descended 
macos: macos 
io: ios 
android: android 
net: net 
prism: prism 
rebranded: rebranded 
fully: fully 
recent: recent 
unicode: unicode 
generic: generics 
xe: xe 
providing: providing 
convenient: convenient 
powerful: powerful 
legacy: legacy 
develop: develop 
public: public 
license: license 
gpl: gpl 
package: packages 
runtime: runtime 
modified: modified 
lesser: lesser 
lgpl: lgpl 
current: current 
intel: intel 
microcontrollers: microcontrollers 
chrome: chrome 
mono: mono 
sold: sold 
remobjects: remobjects 
backend: backend 
kylix: kylix 
descendant: descendant 
longer: longer 
supported: supported 
gpc: gpc 
gcc: gcc 
mostly: mostly 
ansi: ansi 
partial: partial 
painful: painful 
omission: omissions 
absence: absence 
short: short 
quite: quite 
vitaly: vitaly 
miryanov: miryanov 
commercially: commercially 
fprint: fprint 
freeware: freeware 
canceled: canceled 
april: april 
subsequent: subsequent 
adaption: adaption 
smart: smart 
mobile: mobiles mobile 
studio: studio 
html: html 
javascript: javascript 
dominant: dominant 
extremely: extremely 
compactly: compactly 
debug: debug 
accessing: accessing 
disk: disk 
slow: slow 
floppy: floppy 
drive: drives 
magnifying: magnifying 
speed: speed 
advantage: advantage 
currently: currently 
older: older 
download: download 
site: site 
according: according 
parallel: parallel 
tasking: tasking 
semaphore: semaphores 
dimension: dimensions 
allocated: allocated 
overload: overloads 
override: overrides 
built: built 
tailored: tailored 
recompiled: recompiled 
even: even 
xt: xt 
siemens: siemens 
sinix: sinix 
pocketstudio: pocketstudio 
tool: tool 
palm: palm 
mc: mc 
xxx: xxx 
assist: assist 
interfacing: interfacing 
resembles: resembles 
visual: visual 
designer: designer 
inspector: inspector 
editor: editors editor 
midletpascal: midletpascal 
generates: generates 
specifically: specifically 
simd: simd 
instruction: instruction 
mmx: mmx 
amd: amd 
sony: sony 
playstation: playstation 
emotion: emotion 
engine: engine 
morfik: morfik 
server: servers server 
browser: browser 
wdsibyl: wdsibyl 
handheld: handheld 
amigapascal: amigapascal 
amiga: amiga 
vax: vax 
compliant: compliant 
openvms: openvms 
stony: stony 
brook: brook 
optimizing: optimizing 
direct: direct 
executed: executed 
least: least 
twice: twice 
dev: dev 
backends: backends 
numerous: numerous 
freebsd: freebsd 
fire: fire 
water: water 
wol: wol 
creating: creating 
gui: gui 
country: country 
american: american 
ieee: ieee 
differed: differed 
conformant: conformant 
boundary: boundaries 
known: known 
correct: correct 
error: errors error 
ambiguity: ambiguities 
document: document 
stated: stated 
clarification: clarification 
detailed: detailed 
user: users user 
manual: manual 
request: request 
approval: approval 
precipitating: precipitating 
cause: cause 
wanted: wanted 
nag: nag 
varying: varying 
consideration: considerations 
motivated: motivated 
inclusion: inclusion 
specify: specify 
functional: functional 
referred: referred 
differentiate: differentiate 
documented: documented 
originated: originated 
followed: followed 
greatest: greatest 
typically: typically 
important: important 
understand: understand 
whether: whether 
particular: particular 
corresponds: corresponds 
differ: differ 
advent: advent 
featured: featured 
survive: survive 
need: needs 
expansion: expansion 
identical: identical 
technical: technical 
freepascal: freepascal 
planned: planned 
eth: eth 
bootstrap: bootstrap 
undiscriminated: undiscriminated 
packing: packing 
interprocedural: interprocedural 
gotos: gotos 
omitted: omitted 
professor: professor 
consequently: consequently 
shared: shared 
continued: continued 
although: although 
actually: actually 
expanded: expanded 
complete: complete 
installation: installation 
alan: alan 
burn: burns 
geoff: geoff 
davy: davies 
fc: fc 
concurrent: concurrent 
monitor: monitors 
channel: channels 
remote: remote 
invocation: invocation 
demonstrate: demonstrate 
concurrency: concurrency 
simulated: simulated 
fair: fair 
simulate: simulate 
extreme: extreme 
unfair: unfair 
independent: independent 
probably: probably 
suitable: suitable 
microprocessor: microprocessor 
shrink: shrink 
wrapped: wrapped 
incarnation: incarnations 
near: near 
compatibles: compatibles 
shareware: shareware 
author: authors 
swag: swag 
amount: amount 
mind: mind 
category: categories category 
exe: exe 
tpw: tpw 
pure: pure 
hispeed: hispeed 
atari: atari 
st: st 
line: line 
inventor: inventor 
essentially: essentially 
underlying: underlying 
fpc: fpc 
de: de 
facto: facto 
pascalabc: pascalabc 
discontinued: discontinued 
builder: builder 
degree: degrees 
vp: vp 
sybil: sybil 
include: include 
company: company 
speedsoft: speedsoft 
sourced: sourced 
closed: closed 
ongoing: ongoing 
ec: ecs 
wdsybl: wdsybl 
sibyl: sibyl 
class: classes 
spcc: spcc 
svde: svde 
core: core 
som: som 
wps: wps 
opendoc: opendoc 
processing: processing 
graphic: graphics 
kernel: kernel 
gks: gks 
binding: bindings 
wide: wide 
variety: variety varieties 
response: responses 
critical: critical 
complimentary: complimentary 
closely: closely 
initial: initial 
criticized: criticized 
unsuitable: unsuitable 
brian: brian 
kernighan: kernighan 
popularized: popularized 
outlined: outlined 
favorite: favorite 
described: described 
accept: accept 
unfeasible: unfeasible 
sorting: sorting 
unpredictable: unpredictable 
evaluation: evaluation 
poor: poor 
raised: raised 
escape: escape 
knowingly: knowingly 
forcibly: forcibly 
ignore: ignore 
limitation: limitations 
complaint: complaints 
noted: noted 
sometimes: sometimes 
consequence: consequences 
mutual: mutual 
recursion: recursion 
predefine: predefine 
expected: expected 
despite: despite 
evolve: evolve 
apply: apply 
predicted: predicted 
fix: fix 
incompatible: incompatible 
seem: seem 
condensed: condensed 
initialization: initialization 
circuit: circuit 
otherwise: otherwise 
portalbox: portalbox 
right: right 
solid: solid 
aaa: aaa 
tleft: tleft 
tright: tright 
ul: ul 
display: display 
table: table 
box: box boxes 
sizing: sizing 
height: height heights 
weight: weight 
bold: bold 
li: li 
row: row 
span: span 
cell: cell 
vertical: vertical 
middle: middle 
portal: portal 
comparison: comparison 
pascalcase: pascalcase 
reflist: reflist 
decimal: decimal 
inherit: inherit 
column: columns column 
ol: ol 
page: page pages 
break: break 
upper: upper 
alpha: alpha 
roman: roman 
lower: lower 
greek: greek 
cite: cite 
citation: citation 
wrap: wrap 
q: q 
quote: quotes 
rgba: rgba 
id: id 
lock: lock 
linear: linear 
gradient: gradient 
url: url 
upload: upload 
wikimedia: wikimedia 
org: org 
green: green 
svg: svg 
registration: registration 
gray: gray 
alt: alt 
subscription: subscription 
aa: aa 
red: red 
icon: icon 
wikisource: wikisource 
logo: logo 
hidden: hidden 
visible: visible 
maint: maint 
format: format 
kern: kern 
selflink: selflink 
delegate: delegates 
archived: archived 
looked: looked 
carefully: carefully 
prototype: prototype 
method: method 
interaction: interaction 
apis: apis 
conclusion: conclusion 
unnecessary: unnecessary 
detrimental: detrimental 
decision: decision 
previous: previous 
experience: experience 
techmetrix: techmetrix 
pdf: pdf 
went: went 
ahead: ahead 
old: old 
make: makes 
conversation: conversation 
james: james 
gosling: gosling 
acm: acm 
july: july 
retrieved: retrieved 
august: august 
contribution: contributions 
perspective: perspectives perspective 
hertzfeld: hertzfeld 
andy: andy 
hungarian: hungarian 
folklore: folklore 
wayback: wayback 
story: stories 
showcase: showcase 
tiobe: tiobe 
com: com 
index: index 
january: january 
antique: antique 
v: v 
cbi: cbi 
umn: umn 
edu: edu 
interview: interview 
john: john 
brackett: brackett 
doug: doug 
ross: ross 
permanent: permanent 
dead: dead 
charles: charles 
babbage: babbage 
institute: institute 
establishment: establishment 
lucas: lucas 
nuclear: nuclear 
technology: technology 
branch: branch 
divisional: divisional 
agency: agency 
ieae: ieae 
jon: jon 
udell: udell 
crash: crash 
trofimov: trofimov 
march: march 
rall: rall 
l: l 
doi: doi 
pi: pi 
cadmus: cadmus 
jetzt: jetzt 
mit: mit 
kulisch: kulisch 
arithmetik: arithmetik 
uni: uni 
gibt: gibt 
nach: nach 
nchen: nchen 
delivers: delivers 
munich: munich 
computerwoche: computerwoche 
german: german 
germany: germany 
idg: idg 
business: business 
medium: media 
gmbh: gmbh 
november: november 
universitaet: universitaet 
wissenschaftliches: wissenschaftliches 
rechnen: rechnen 
softwaretechnologie: softwaretechnologie 
bamberger: bamberger 
lothar: lothar 
davenport: davenport 
h: h 
fischer: fischer 
han: hans 
christoph: christoph 
kok: kok 
jan: jan 
schumacher: schumacher 
nter: nter 
ullrich: ullrich 
christian: christian 
wallis: wallis 
peter: peter 
winter: winter 
dik: dik 
wolff: wolff 
von: von 
gudenberg: gudenberg 
rgen: rgen 
ed: ed 
improving: improving 
bath: bath 
united: united 
kingdom: kingdom 
wiley: wiley 
son: sons 
ltd: ltd 
isbn: isbn 
michel: michel 
gien: gien 
usenix: usenix 
conference: conference 
toronto: toronto 
berkeley: berkeley 
mandell: mandell 
steven: steven 
west: west 
publishing: publishing 
sneeringer: sneeringer 
insecurity: insecurities 
nell: nell 
dale: dale 
chip: chip 
weems: weems 
n: n 
barron: barron 
september: september 
ethz: ethz 
fortan: fortan 
ieeestd: ieeestd 
wiki: wiki 
wolfgang: wolfgang 
october: october 
netlabs: netlabs 
lecarme: lecarme 
desjardins: desjardins 
comment: comments 
acta: acta 
informatica: informatica 
wikibooks: wikibooks 
topic: topic 
volume: volume 
note: notes 
dahl: dahl 
dijkstra: dijkstra 
academic: academic 
press: press 
axiomatic: axiomatic 
kathleen: kathleen 
springer: springer 
verlag: verlag 
prentice: prentice 
hall: hall 
assessment: assessment 
sigplan: sigplan 
notice: notices 
june: june 
wasserman: wasserman 
society: society 
grogono: grogono 
edition: edition 
addison: addison 
wesley: wesley 
richard: richard 
forsyth: forsyth 
play: play 
chapman: chapman 
broy: broy 
denert: denert 
successor: successors 
pioneer: pioneers 
engineering: engineering 
recollection: recollections 
navbox: navbox 
subgroup: subgroup 
abovebelow: abovebelow 
white: white 
nowrap: nowrap 
fdfdfd: fdfdfd 
tr: tr 
ccf: ccf 
ddf: ddf 
ff: ff 
odd: odd 
hlist: hlist 
td: td 
dl: dl 
inline: inline 
collapse: collapse 
boxtext: boxtext 
spacing: spacing 
bracket: brackets 
abbr: abbr 
decoration: decoration 
mini: mini 
cap: caps 
cursor: cursor 
ct: ct 
script: script 
joyce: joyce 
superpascal: superpascal 
pic: pic 
micro: micro 
ack: ack 
jrt: jrt 
mt: mt 
clx: clx 
fcl: fcl 
firemonkey: firemonkey 
lcl: lcl 
openwire: openwire 
rtl: rtl 
vision: vision 
microengine: microengine 
nobold: nobold 
lola: lola 
active: active 
aos: aos 
bluebottle: bluebottle 
formalism: formalisms 
law: law 
notation: notation 
precedence: precedence 
relationship: relationship 
workstation: workstations 
lilith: lilith 
cere: ceres 
workplace: workplaces 
stanford: stanford 
zurich: zurich 
xerox: xerox 
parc: parc 
collaborator: collaborators 
rg: rg 
gutknecht: gutknecht 
hanspeter: hanspeter 
ssenb: ssenb 
ck: ck 
award: award awards 
turing: turing 
achievement: achievement 
fellow: fellow 
museum: museum 
marcel: marcel 
benoist: benoist 
prize: prize 
romanizations: romanizations 
wip: wip 
t: ts 
timeline: timeline 
apl: apl 
cobol: cobol 
erlang: erlang 
forth: forth 
haskell: haskell 
kotlin: kotlin 
lua: lua 
perl: perl 
php: php 
prolog: prolog 
python: python 
ruby: ruby 
rust: rust 
sql: sql 
shell: shell 
smalltalk: smalltalk 
swift: swift 
alphabetical: alphabetical 
categorical: categorical 
generational: generational 
english: english 
authority: authority 
national: national 
france: france 
state: states 
faceted: faceted 
subject: subject 
terminology: terminology 
bar: bar 
flex: flex 
justify: justify 
item: items item 
baseline: baseline 
bordered: bordered 
unbordered: unbordered 
gap: gap 
newpp: newpp 
limit: limit 
parsed: parsed 
cached: cached 
cache: cache 
expiry: expiry 
reduced: reduced 
complication: complications 
vary: vary 
revision: revision 
sha: sha 
cpu: cpu 
usage: usage 
preprocessor: preprocessor 
visited: visited 
count: count 
post: post 
expand: expand 
template: template 
argument: argument 
highest: highest 
expensive: expensive 
unstrip: unstrip 
wikibase: wikibase 
entity: entities 
loaded: loaded 
transclusion: transclusion 
m: ms 
call: calls 
sister: sister 
saved: saved 
enwiki: enwiki 
pcache: pcache 
idhash: idhash 
canonical: canonical 
timestamp: timestamp 
serialized: serialized 
json: json 
oldid: oldid 
educational: educational 
webarchive: webarchive 
permanently: permanently 
description: description 
match: matches 
wikidata: wikidata 
message: message 
bnf: bnf 
lccn: lccn 
menu: menu 
