mick: mick 
jagger: jagger 
child: children 
age: age 
song: songs 
biography: biography 
skip: skip 
main: main 
content: content 
people: people 
nostalgia: nostalgia 
celebrity: celebrity 
history: history 
culture: culture 
crime: crime 
scandal: scandal 
video: video videos 
contact: contact 
u: us u 
advertise: advertise 
privacy: privacy 
notice: notice 
term: terms 
use: use 
copyright: copyright 
policy: policy 
ad: ad 
choice: choices 
accessibility: accessibility 
support: support 
setting: settings 
february: february 
subscribe: subscribe 
newsletter: newsletter 
photo: photo 
terry: terry 
neill: neill 
hulton: hulton 
archive: archive 
getty: getty 
image: image images 
quick: quick 
fact: facts fact 
name: name 
birth: birth 
date: date 
july: july 
education: education 
london: london 
school: school 
economics: economics 
place: place places 
dartford: dartford 
england: england 
zodiac: zodiac 
sign: sign 
leo: leo 
early: early 
life: life lives 
musical: musical 
influence: influence influences 
forming: forming 
rolling: rolling 
stone: stones 
tragedy: tragedy 
strike: strikes 
hit: hits hit 
branching: branching 
related: related 
cite: cite 
page: page 
quote: quotes 
never: never 
wanted: wanted 
give: give 
performing: performing 
stage: stage 
one: one 
day: day days 
tour: tours tour 
publish: publish 
apr: apr 
comment: comment 
lead: lead 
singer: singer 
become: become 
rock: rock 
legend: legend 
gritty: gritty 
blue: blue blues 
influenced: influenced 
charismatic: charismatic 
presence: presence 
delighting: delighting 
fan: fans 
four: four 
decade: decades decade 
leaving: leaving 
start: start 
band: band bands 
keith: keith 
richards: richards 
took: took 
top: top 
music: music 
world: world 
major: major 
like: likes like 
get: get 
satisfaction: satisfaction 
angie: angie 
miss: miss 
propelling: propelling 
status: status 
unknown: unknown 
performer: performers 
michael: michael 
phillip: phillip 
born: born 
known: known 
delighted: delighted 
legion: legion 
oldest: oldest 
son: son sons 
teacher: teacher 
homemaker: homemaker 
good: good 
student: student 
popular: popular 
among: among 
classmate: classmates 
developed: developed 
interest: interest 
american: american 
r: r 
b: b 
got: got 
first: first 
guitar: guitar 
teenager: teenager 
started: started 
collecting: collecting 
record: record records 
muddy: muddy 
water: waters 
howlin: howlin 
wolf: wolf 
friend: friend friends 
dick: dick 
taylor: taylor 
soon: soon 
together: together 
called: called 
little: little 
boy: boy boys 
accepted: accepted 
lived: lived 
home: home 
commuted: commuted 
city: city 
attend: attend 
class: classes 
also: also 
working: working 
added: added 
new: new 
member: member 
guitarist: guitarist 
two: two 
growing: growing 
exploring: exploring 
emerging: emerging 
scene: scene 
spent: spent 
time: time 
ealing: ealing 
club: club 
saw: saw 
alexis: alexis 
korner: korner 
incorporated: incorporated 
play: play 
wowed: wowed 
brian: brian 
jones: jones 
xa: xa 
made: made 
guest: guest 
appearance: appearances 
group: group 
appeared: appeared 
vocalist: vocalist 
joined: joined 
pianist: pianist 
ian: ian 
stewart: stewart 
would: would 
charlie: charlie 
watt: watts 
drummer: drummer 
departed: departed 
replaced: replaced 
bill: bill 
wyman: wyman 
however: however 
stayed: stayed 
serve: serve 
road: road 
manager: manager 
well: well 
playing: playing 
recording: recording 
direction: direction 
andrew: andrew 
loog: loog 
oldham: oldham 
marketed: marketed 
wild: wild 
rough: rough 
rocker: rockers rocker 
style: style 
helped: helped 
land: land 
deal: deal 
decca: decca 
key: key 
ingredient: ingredient 
success: success 
attracting: attracting 
audience: audiences audience 
antic: antics 
sex: sex 
appeal: appeal 
mostly: mostly 
recorded: recorded 
cover: cover 
version: version versions 
along: along 
bandmates: bandmates 
emerged: emerged 
powerful: powerful 
songwriting: songwriting 
team: team 
occasionally: occasionally 
using: using 
pseudonym: pseudonym 
nanker: nanker 
phelge: phelge 
work: work 
british: british 
chart: chart charts 
bobby: bobby 
womack: womack 
year: years year 
released: released 
debut: debut 
album: albums album 
toured: toured 
united: united 
state: states 
girl: girls girl 
belongs: belongs 
yesterday: yesterday 
followed: followed 
including: including 
topping: topping 
paint: paint 
black: black 
head: heads 
aftermath: aftermath 
personal: personal 
headline: headlines 
girlfriend: girlfriend 
marianne: marianne 
faithfull: faithfull 
arrested: arrested 
police: police 
raid: raid 
country: country 
search: search 
officer: officers 
found: found 
drug: drug drugs 
paraphernalia: paraphernalia 
illegal: illegal 
substance: substances 
tried: tried 
convicted: convicted 
offense: offenses 
sentence: sentences 
dropped: dropped 
later: later 
possession: possession 
authority: authorities 
raided: raided 
end: end 
rest: rest 
enjoying: enjoying 
huge: huge 
beggar: beggars 
banquet: banquet 
featured: featured 
straightforward: straightforward 
single: singles 
jumpin: jumpin 
jack: jack 
flash: flash 
spot: spot 
k: k 
reached: reached 
went: went 
several: several 
big: big 
change: changes 
left: left 
june: june 
many: many 
arrest: arrests 
prevented: prevented 
old: old 
drowned: drowned 
pool: pool 
le: less 
month: months month 
coroner: coroner 
report: reports report 
alcohol: alcohol 
death: death 
ruled: ruled 
passing: passing 
misadventure: misadventure 
response: response 
untimely: untimely 
demise: demise 
performed: performed 
free: free 
concert: concert 
hyde: hyde 
park: park 
former: former 
bandmate: bandmate 
originally: originally 
scheduled: scheduled 
opportunity: opportunity 
present: present 
dedicated: dedicated 
began: began 
read: read 
excepts: excepts 
percy: percy 
shelley: shelley 
adonais: adonais 
poem: poem 
stagehand: stagehands 
hundred: hundreds 
white: white 
butterfly: butterflies 
part: part 
tribute: tribute 
played: played 
favorite: favorite 
struck: struck 
launched: launched 
highly: highly 
anticipated: anticipated 
let: let 
bleed: bleed 
promote: promote 
organized: organized 
altamont: altamont 
speedway: speedway 
northern: northern 
california: california 
december: december 
thumb: thumb 
young: young 
man: man 
stabbed: stabbed 
killed: killed 
hell: hell 
angel: angels 
motorcycle: motorcycle 
gang: gang 
tragic: tragic 
event: event 
captured: captured 
film: film 
documentary: documentary 
gimme: gimme 
shelter: shelter 
outside: outside 
acting: acting 
title: title 
character: character 
legendary: legendary 
outlaw: outlaw 
ned: ned 
kelly: kelly 
performance: performances performance 
reclusive: reclusive 
star: star 
neither: neither 
much: much 
impression: impression 
movie: movie 
next: next 
bella: bella 
hadid: hadid 
sadie: sadie 
alexander: alexander 
adrienne: adrienne 
kennedy: kennedy 
screen: screen 
escaped: escaped 
remained: remained 
sticky: sticky 
finger: fingers 
exile: exile 
st: st 
emotional: emotional 
rescue: rescue 
tattoo: tattoo 
mid: mid 
relationship: relationship 
increasingly: increasingly 
strained: strained 
focused: focused 
energy: energy 
solo: solo 
career: career 
mixed: mixed 
result: results 
effort: effort 
bos: boss 
sold: sold 
enough: enough 
go: go 
platinum: platinum 
second: second 
primitive: primitive 
cool: cool 
failed: failed 
buyer: buyers 
hall: hall 
fame: fame 
inducted: inducted 
roll: roll 
decided: decided 
around: around 
resulting: resulting 
steel: steel 
wheel: wheels 
extensively: extensively 
hand: hand 
another: another 
wandering: wandering 
spirit: spirit 
met: met 
lukewarm: lukewarm 
enthusiasm: enthusiasm 
following: following 
fared: fared 
better: better 
voodoo: voodoo 
lounge: lounge 
received: received 
strong: strong 
mark: marks 
critic: critics 
winning: winning 
grammy: grammy 
best: best 
bridge: bridges 
babylon: babylon 
bigger: bigger 
bang: bang 
aspired: aspired 
establish: establish 
artist: artist 
goddess: goddess 
doorway: doorway 
producer: producer 
project: projects 
woman: women 
animated: animated 
ruby: ruby 
tuesday: tuesday 
viewed: viewed 
rebellious: rebellious 
picture: picture 
decorum: decorum 
knighted: knighted 
prince: prince 
charles: charles 
historic: historic 
havana: havana 
march: march 
cuba: cuba 
previously: previously 
banned: banned 
communist: communist 
regime: regime 
subversive: subversive 
visit: visit 
president: president 
barack: barack 
obama: obama 
prior: prior 
normalize: normalize 
relation: relations 
special: special 
long: long 
show: show 
milestone: milestone 
hope: hope 
said: said 
statement: statement 
ciudad: ciudad 
deportivo: deportivo 
sport: sports 
arena: arena 
south: south 
continued: continued 
captivate: captivate 
live: live 
postpone: postpone 
north: north 
kick: kick 
april: april 
recover: recover 
heart: heart 
surgery: surgery 
father: father 
eight: eight 
daughter: daughter daughters 
named: named 
karis: karis 
hunt: hunt 
november: november 
actress: actress 
marsha: marsha 
became: became 
involved: involved 
bianca: bianca 
perez: perez 
moreno: moreno 
de: de 
macias: macias 
couple: couple 
married: married 
welcomed: welcomed 
jade: jade 
sheena: sheena 
jezebel: jezebel 
october: october 
wed: wed 
longtime: longtime 
model: model 
jerry: jerry 
james: james 
leroy: leroy 
augustin: augustin 
august: august 
gabriel: gabriel 
luke: luke 
beauregard: beauregard 
elizabeth: elizabeth 
scarlett: scarlett 
georgia: georgia 
may: may 
ayeesha: ayeesha 
january: january 
ended: ended 
discovered: discovered 
affair: affair 
luciana: luciana 
gimenez: gimenez 
morad: morad 
initial: initial 
dispute: dispute 
paternity: paternity 
established: established 
lucas: lucas 
maurice: maurice 
romantically: romantically 
linked: linked 
designer: designer 
l: l 
wren: wren 
scott: scott 
fashion: fashion 
brand: brand 
reported: reported 
dead: dead 
apparent: apparent 
suicide: suicide 
according: according 
hanged: hanged 
australia: australia 
news: news 
broke: broke 
going: going 
ballerina: ballerina 
melanie: melanie 
hamrick: hamrick 
deveraux: deveraux 
octavian: octavian 
basil: basil 
dating: dating 
tina: tina 
turner: turner 
move: moves 
tv: tv 
check: check 
strive: strive 
accuracy: accuracy 
fairness: fairness 
see: see 
something: something 
look: look 
right: right 
citation: citation 
information: information 
article: article 
author: author 
com: com 
editor: editors 
website: website 
url: url 
access: access 
publisher: publisher 
e: e 
television: television 
network: networks 
last: last 
updated: updated 
original: original 
published: published 
receive: receive 
story: stories 
shaped: shaped 
person: person 
johnny: johnny 
cash: cash 
songwriter: songwriter 
whose: whose 
innovatively: innovatively 
gospel: gospel 
david: david 
bowie: bowie 
english: english 
dramatic: dramatic 
transformation: transformations 
ziggy: ziggy 
stardust: stardust 
roger: roger 
queen: queen 
peter: peter 
frampton: frampton 
musician: musician 
humble: humble 
pie: pie 
herd: herd 
come: comes 
alive: alive 
million: million 
copy: copies 
george: george 
flamboyant: flamboyant 
androgynous: androgynous 
fronted: fronted 
chuck: chuck 
berry: berry 
influential: influential 
n: n 
maybellene: maybellene 
goode: goode 
chris: chris 
martin: martin 
coldplay: coldplay 
multiple: multiple 
award: awards 
paradise: paradise 
yellow: yellow 
viva: viva 
la: la 
vida: vida 
amy: amy 
winehouse: winehouse 
five: five 
connected: connected 
back: back 
remembered: remembered 
rehab: rehab 
valerie: valerie 
jim: jim 
morrison: morrison 
door: doors 
paris: paris 
loading: loading 
logo: logo 
registered: registered 
trademark: trademarks 
llc: llc 
close: close 
